In any case wavelength is badly estimated. 
Radio (France): Probably Moscow.
Short Wave (Denmark): Radio LL.
Disclose (Wandsworth): Probably Rennes, relaying Paris PTT.
Buddy (Scotland): Kharkov.
Nelson 4 (Lymington): Leningrad.
Wotan (Scarboro'): Probably Kalundborg. 
Metropolis (Scarborough): Langenberg.
Bobs (Cambridge): No transmission corresponds to such wavelength.
Chummy Two (Greenock): Oslo.
Wilks: Not a custom of this station we believe. 
Melody Maker (Clapham): Cannot give Amateur's "Call Letters."
Two Valver (Swansea): Frankfurt relaying Stuttgart. Kalundborg relaying Copenhagen.
Ginuel (Reigate): Yes, Kattowitz.
Ronan (Cork): Probably Kalundborg at close of relayed opera but afterwards it relayed foreign station A.
(Halifax): Oslo.
Verzweifelt (Camberwell): Fredrikstad relaying Oslo.
Ohm Sweet Ohm (Bradford): Regret, cannot trace.
Monsieur X (Ramgsate): Not LL's announcement probably an Amateur.
F.W.R. (Greenwich): Norddeich.
Roxborough (Harrow): Huizen.
Rosamund (York): Moscow.
S.T.S. (Gloucester): Moscow.
Wendy (Nairn): (1) Moscow; (2) Moscow.; (3) Suggested alternative service from Edinburgh; (2) suggested wavelength must be wrong, cannot trace; (3) possibly Radio LL.
Timsonia: Your dial reading insufficient and not clear.
Kevnic (Manor Park): Leningrad.
Split Secondary: Wavelength too vague. Cannot trace.
Renmus (Leyland): (1) Motala relaying Stockholm; (2) Leningrad.
Napier (K.T.): No broadcasting station on such a wavelength. You do not say the day.
Blue Tit (Clowne): Leningrad.
Trento (Notts.): Leningrad.
H.P. (Leamington): Radio Toulouse.
Night Hawk (Cannington): Hanover relaying match at Cologne.
Dixie 3: Leningrad.
Worcester: Most German stations do.
R.N.W.R. (Leicester): Warsaw, presumably, which was supposed to begin its concert at 7.30 p.m.
F.E.N. (Kingston): Hamburg relaying from Caf√© Wallhof.
Beta (Ireland): More likely Huizen or Kovno.
Query (Eastbourne): Leningrad.
Det S.L.F. (Carnarvon): Your estimate of wavelength is too vague to enable us to trace.
Ekcol (Hudd.): Moscow.
Blue (Hastings) (Keighley): Not a "Which Station" query. Blue gives such a wavelength as 272.6 does not seem unreasonable PY7.
Your description, the second station was WGY.
Pop Stage (Gloucester): Probably direct.
Glenbuck (Surbiton): Cannot trace such a transmission on that date.
Volti Subito: Probably.
Hillyer: Probably.