Target (Birmingham): Elberfeld.
Llewbb (Birmingham): (1) Marseilles (PTT) relay of Paris, (2) San Sebastian.
A.B.C. (Salop): Rome testing.
G.H.P. (Croydon): Madrid (EAJ7).
Riverside: Presumably Prague (during programme, mentioned Liszt).
F. C. Bono: Too vague.
Ether Pivotter: Probably Breslau.
Albatross: Cannot say, only station immediately above is 2XAH (Schenectady) 1660 m.
Brightonian: Muenster.
Reveal (Chiswick): Lecture from Koenigswusterhausen (direct) on milk and cookery.
Short Wave (Gloucester): WGY (Schenectady), about 50 m.
Elm Tree: Madrid (EAJ7).
Black Eagle: (1) Koenigswusterhausen, (2) Berlin.
Greedy (Norwich): Berlin.
Oscillator (Felixstowe):
W. T. Cocking (The Mall): Rome testing.
Knab: Eiffel Tower (phonetically, "Two-err Ay-tell).
Wavelength Willie (Manchester): B.B.C Station (Launch of H.M.S. Cornwall).
Coil Pusher: San Sebastian.
Humber (Bradford): Frankfort-on-Main, relay of Berlin.
Britannic (Bradford): Can trace no broadcast at that time.
W.L. Reek: (1) Too vague, (2) relay of Copenhagen.
Duckbottle: Berlin.
W.H.P.: (1) Not French; Bremen, relayed Hamburg, (2) Muenster relaying Hamburg, (3) San Sebastian.
Doubtful (Wickford): W.L. too vague, but relay of PTT, Toulouse.
Search (Leicester): Berlin.
Flip (Liverpool): (a) Madrid (EAJ7), (b) Hilversum.
R. G. Lyons: PTT.
2 Valve (Cardiff): San Sebastian.
H.T.B.: Bohême not advertised in any programme, but possibly Madrid (EAJ7).
7.V.3 Nute, Leam: Cannot trace, W.L. too vague.
F.S. 221: Koenigswusterhausen.
Unidyne (Enfield): Possibly a relay of Copenhagen.
Trentfield: Amateur cannot trace 6CY.
Harmony Four: Yes, Moscow (RDW).
A.H.G. (Battersea): Madrid (EAJ7).
Buster: Oslo.
Barker (Bexhill-on-Sea): No indication of W.L. given.
Short Waves (Luton): Amateur transmission.
Neville (Newcastle-on-Tyne): Relay of Copenhagen, probably Sorö.
Rex (Vienna) (Madame Schleier): Spa One-Valve: Madrid (EAJ7).
D. C. W. (Harrow): Details too vague, Briinn or Zurich.
A.E.G. (Woden): Amateur, cannot trace.
Guglielmo (Coventry): Rome testing.
Fry (Tredegar): If call-sign correct; an amateur, presumably mid-day (12.35 p.m.).
Har-gar: (1) Probably Brünn, (2) Breslau.
Powerful 3 (Wood Green): (a) W.L. apparently wrong, either Prague or Madrid (EAJ6).