Marconi: more probably WBZ (Springfield) on 333 m.  
Straight Eight: Most likely WBZ (Springfield).  
H. D. Gray: Cadiz (EAJ3).  
Tim (Leicester): Oslo.  
3 Valver (London): Prague.  
Duodyne 5 (Dunston-on-Tyne): Vienna (Rosenhügel).  
Spaghetti (Waverton): (220-240 m.) Stettin, relaying Berlin.  
W. D. S. (Hornchurch): Not in programmes, possibly Milan.  
Wireless Billie (Oldham): Dortmund (morse lesson).  
R. M. C. (Clydebank): WGBS (New York City).  
Steward (Islington): Moscow (RDW).  
Ether Rider: Cannot trace, W.L. apparently wrong.  
Helene: WJZ (Boundbrook).  
Swiller: (1) A relay of Stockholm; (2) Stettin, relaying Berlin; (3) Cannot trace.  
Civic (E. Port): (1) Cannot trace, possibly Moscow (RDW), (2) Karlsborg, relaying Gothenburg.  
Dunmowing (Billesley): Petit Parisien (Paris).  
Veronica (Shiel): Moscow (RDW).  
Ormsby Four: WIOD (Miami Beach) 248 m.  
Schubert: Leningrad (1,100 m.).  
I. G. W. (Pewsey): WPG (Atlantic City).  
Hybernia (Dublin): Moscow (RDW).  
Yankee Doodle (Aldershot): Most probably KDKA (East Pittsburg).  
E. L. B (Paignton): No estimated WL given, a German voice.  
Sitna & Walter: (1) Probably KFO (Washington); (2) chock.  
Bingy: Too vague, but U.S.A. station or Vienna.  
Jeff (Hownham): Your day and date of month do not tally; 23/10 was a Saturday.  
We should not like to say that this was 6WF Perth !  
Veraphone: Moscow (RDW).  
Leven: Leningrad (1,100 m.).  
CF/457 (Birmingham): San Sebastian.  
Puzzled Robinson: Moscow (RDW).  
G. S. M. (Sheffield): Karlsborg, relay of Stockholm.  
Straight Three (Durham): Boden, relaying Stockholm.  
Long Range (Willowbank): (1) Frankfort; (2) WGY (Schenectady); (3) ditto (4) WPG (New York); (5) WJZ (Boundbrook).  
Mustard Club (Stratford Market): WGY (Schenectady).  
Ether Hawk (Hengrave): No date given, but Moscow (RDW).  
Retreat (Vienna): Vienna.  
W. Taylor (Hightown): (1) KFI (Los Angeles); (2) Madrid (EAJ7); (3) Oslo; (4) Hilversum; (5) Basle; (6) Karlsborg, relaying Stockholm.  
Wee Mac IV.: Moscow (RDW) confirmed.  
Hispano Suiza: (2) Yes, Moscow (Peredacha).  
Mag (Willemhal): (8) Moscow (RDW).  
Doctor (Inverness): (1) Apparently Riga (Lettlandsender).  
Frenzied Nightingale: (1) Cannot trace.  
Pepper (Leicester): (2) Madrid (EAJ7).  
T.O.M. (Preston): Frankfort-on-Main.  
R.T.F. (Edinbridge): WGY (Schenectady).  
M. (King’s Lynn): Frankfort a.m.  
L. J. F.: WPG (Atlantic City) 299 m.