Kendal: Amateur (Bootle).

Lucia: Shakespeare (Nottingham): Moscow (RDW).

A.J.G.: Prague.

Wanderer (Mkt. Harbor'): Too vague.

Midnight Oil: Cannot trace.

Furlong-Abrews: Madrid (EAJ.6).

E.D.W.: (6.45) San Sebastian; (10.45) Hamburg.

Jonnie and Ronnie (Redhill): (a) PTT (Paris) or relay; (b) probably Milan.

275: Madrid (EAJ7).

Sleepless (Grimsby): Cannot trace item.

Super Heterodyne: B.B.C. stations.

Recipio: Yes, Madrid (EAJ7).

Aychiff: Hilversum.

Qui Vive (Frome): Hamburg; (10.30) cannot trace item, possibly Bilbao.

Alleyman (S.W. 16): Glasgow.

Second Detector: Too vague.

Ca'ts Whisker: Whisker Twister; Lucky Jim (Grimsby): Madrid (EAJ7).

Behor-Bahar: Cannot trace, probably U.S.A.

I.C.L.1: Hamburg.

S.J.L. (Montrose): Prague.

Kiwi I.O.W.: Hanover.

Sparks: Moscow (1010 m), no programmes available.

Cumnor Hill (Noster): German Aviation Service (1525 m).

Comaca: (8 p.m.) Moscow (RDW); (3 p.m.) Madrid (EAJ4).

Puzzled One Valver: W.L. too vague.

Rexboro (St. Helens): a) PTT (Paris); (b) Hamburg relay of Bremen.

Brum 3: (a) Madrid (EAJ4); (b) Madrid (EAJ7).

Nora: (7.10) Frankfort-on-Main (8.25) probably Reval, but no programmes available.

Unidyne 11: Gothenberg relay of Stockholm Radio.

Shovel: Tour Eiffel (Eiffel Tower).

Condenser: Berlin.

One Valve Set: W.L. too indefinite, probably Madrid (EAJ7).

Cantilever (Forest Hall): San Sebastian.

R.V.B. (Wallasey): Would tally with Hamburg.

Whytegates: What date?

Syndicate: No date given.

Peter: Nuremberg.

Phlox: Ryvang.

Leesone: W.L. too vague on that band.

P.P.V.G.2 (Perth): Presumably U.S.A., possibly WGY (Schenectady).

Cyril: Too indefinite, cannot trace.

C.P.: Berlin.

Fultolia: Prague.

Exchanger: Breslau relaying Gleiwitz.

R.H.P.F. (Leeds): Breslau.

Tulip: Bergen.

L.G.H. (E6): Yes, Cadiz.

Wagner: Moscow (RDW).

Morse (Llanelly): W.G.Y. (Schenectady).

Hawes: W.L. wrong; Stockholm.

Oxo Cube: W.L. too vague.

Sound Detector: Vienna.

H.E.B. (Blackpool): PTT. Paris.

Chercheur: Possibly Moscow.

Zwei Valve (Deal): Cannot trace items.

Kiinie (Forfar): Many British Government stations.

Accumlator (Orford): Hilversum.

B-P.: Berlin.

Gecophone (Warrington): Most certainly not Newfoundland. Cannot trace.

C.R. Wright (Luton): Buda Pest.