If stated languages barred, cannot trace.
Searcher (Grimsby): Hamburg.
Dicky: (a) Hamburg; (b) W.L. wrong.
Iberica: KDKA. 
Sterling: Probably Prague.
Chadlington: Graz relaying Vienna. 
Counterpoise: Prague. 
Bayford: Probably Prague. 
Chackophone: Muenster. 
Juniper: Oslo, but 382m.
Brookfield: Berne. 
Douglas-H.U.T.: Probably Moscow.
Water (Alnwick): Sports talk was on Saturday.
D.L.F. (Hanley): Stoke-on-Trent. 
Robbie M.W.: Berlin.
Glen (Sheff.): Cannot trace. 
Anil: Cannot state definitely, but possibly San Francisco.
Dorithe: San Sebastian.
Wex (Dublin): (1) Amateur; (2) San Sebastian.
Wanted (Swansea): This may have been a test.
Junius (Nelson): (1) W.L. too vague; (2) San Sebastian.
K.T.: Prague.
Nick: Moscow (RDW).
Trans-Atlantic Three: W.L. and Madrid very indefinite, Bremen or Hanover.
Bothwell: Koenigs Wusterhausen.
A.P.A.J.S.: Cannot trace. 
High Tension: Oslo.
Tropadyne: Barcelona (EAJ1). 
Excelsior (Wycombe): Kiel.
H.W.C. (8/1) Madrid (EAJ6); (10/1) Oslo.
W.R.P. (Newport): Kiel. 
Ingatestone (Redwick): Stockholm.
Kendal: Amateur (Bootle). 
Reinartz Junior: Surely Rome (Lucia).
Shakespeare (Nottingham): Moscow (RDW).
A.J.G.: Prague. 
Wanderer (Mkt. Harboroâ€™): Too vague.
Midnight Oil: Cannot trace.
Furlong-Abrewas: Madrid (EAJ6).
E.D.W.: (6.45) San Sebastian; (10.45) Hamburg.
Lonnie and Ronnie (Redhill): (a) PTT (Paris) or relay, (b) probably Milan.
275 S.: Madrid (EAJ7).
Sleepless (Grimsby): Cannot trace item.
Super Heterodyne: B.B.C. stations.
Recippo: Yes, Madrid (EAJ7).
Aychiff: Hilversum. 
Qui Vive (Frome): Hamburg; (10.30) cannot trace item, possibly Bilbao.
Alleyman (S.W. 16): Glasgow.
Second Detector: Too vague.
Cats Whisker: 
Whisker Twister; 
Lucky Jim (Grimsby): Madrid (EAJ7).
Behoer-Bahar: Cannot trace, probably U.S.A. 
I.C.L.L.: Hamburg.
S.J.L. (Montrose): Prague.
Kiwi I.O.W.: Hanover.
Sparks: Moscow (1010 m), no programmes available.
Cumnor Hill (Foster): German Aviation Service (1525 m).
Comaca: (8 p.m.) Moscow (RDW), (8 p.m.) Madrid (EAJ4).
Puzzled One Valver: W.L. too vague.
Rexboro (St. Helens): (a) PTT (Paris); (b) Hamburg, relay of Bremen.
Brum 3: (6/1) Madrid (EAJ4), (3/8) Madrid (EAJ7).
Nora: (7.10) Frankfort-on-Main; 7 p.m. Hamburg.