fragment

M.E.E.W.: (1) Amateur, cannot trace.

(2) Cadiz (EAJ3).

Samac (Liverpool): Frankfort-on-Main.

Nobby: Cadiz (EAJ3).

B.S. (Swansea): Cannot trace any European station working at that time.

A.H. Rugeley (Staffs): Barcelona (EAJ13).

Duncroft: San Sebastian.

Major Aberfan: (1) Too vague, cannot trace; (2) Madrid (EAJ7).

Hibernia: Moscow (RDW).

Hobart (Camden Town): Frankfort-on-Main (470 m.).

Curious (Liverpool): Can trace only Oslo (382 m.) closing at that time.

H.J.H.: (8/8) Frankfort, relay of Berlin.

(9/8) Frankfort-on-Main, relay of a wrestling match.

Twin Valve (Gerrards Cross): Frankfort-on-Main (gramophone records).

Loud Speaker (Levenshulme), Devo, Two Valver (Belfast): Frankfort-on-Main (gramophone records).

Clover (Glasgow 5MN): either Barcelona (EAJ18) or Seville (EAJ17), but no programmes available.

Morris Oxford (Eastbourne): (1) Munich, (2) Rome, (3) Breslau, (4) Dublin, (5) Madrid (EAJ3), (6) San Sebastian, (7) Milan.

Twin Valve (Reflex): Munich.

Beginner: Cannot trace, no estimated WL, given but German station.

Grid Bias: Frankfort-on-Main (gramophone records).

Electron: Yes, both Koenigs Wusterhausen.

Ben (Forest Gate): Prague.

H.J. (Walthamstow): (1) San Sebastian, (2) Koenigsberg.

A.G.F. (Hornsey): Munich (485 m.).

Interested: WL too indefinite, cannot trace.

Anglo American (Woodford): Frankfort-on-Main.

2 Valver (Pitsea): Buda-Pesth.

Toddies: (1) Milan, (2) probably amateur, (3) either Barcelona (EAJ18), or Seville (EAJ17), but no programmes available.

A.E.B. (Seedley): Munich.

Dunelm: Frankfort-on-Main (gramophone records).

Mio (Birkenhead): Details too vague, probably Hamburg.

Wave Catcher (Putney): (1) Stettin (news), (2) Koenigsberg.

Newman, Rags: Munich.

Seabee (Birmingham): Prague.

Great Unknown (Huddersfield): WL wrong, Sor√∏, relay of Copenhagen.

Old Ford: Bilbao (EAJ9).

Neutrodyne (Dorking): Probably Mont-de-Marsan, but more likely to be PTT, Bordeaux (411m).

Ged R. Ferry: Buda-Pesth.

Cafe Continental, Et Azur: Hamburg, relay of Hanover.

Potentiostat (Bristol): (1) Copenhagen, (2) cannot trace.

Pan: Either Barcelona (EAJ18), or Seville (EAJ17), but no programmes available.

C.J. (Cardiff): Frankfort-on-Main.