neville (Newcastle-on-Tyne): Munich.
Ethodyne (Brighton): Stuttgart.
W.W.W.: (1) Estimated WL much too vague; so many German stations covered; (2) PTT, Paris; (3) Madrid (EAJ6).
Bessbrough: PTT Toulouse, relay of Paris.
Garrotes: Details vague, presumably Madrid (EAJ7).
Hawes (Upwell): No time given.
P.K. (Warrington): Cadiz.
Merry and Bright: (1) Frankfort-on-Main; (2) Barcelona (EAJ13); (3) WEAF (New York).
Twin: Details too vague, possibly Antwerp.
Ireland (Camden Town): Madrid (EAJ7).
X.B.Z. (Bideford): (1) Frankfort-on-Main (gramophone records); (2) Madrid (EAJ6); (3) Muenster; (4) Leipzig.
We are Seven (Strood): (a) Can dance music transmission on that WL; (b) Frankfort-on-Main (gramophone records).
A.B.C. (Bootle): Berlin.
Ether Comber: Elberfeld, relay of Muenster.
Amico: Milan.
Bell (Newton Abbot): (1) no coupon; (2) Madrid (EAJ7).
Barumite: Frankfort-on-Main (gramophone records).
Four Valve: (1) WL wrong, probably Cassel (279 m.); (2) cannot trace morse stations.
C. E. Draper: Berlin, relay of Stuttgart (taking 4 Midland ‘Nights’ from there!).
U.S.B. (Heaton Moor): (1) Bilbao (EAJ11); (2) Frankfort-on-Main (gramophone records).
Wantreply (Birmingham): See World Radio, issue August 6.
Short Wave: No date.
Chim Chim (Moscow (RDW).
2VHV.24.: Frankfort-on-Main relay of Berlin.
Nunthorpe: Berlin (1300 m.).
G.S.E.C. (Leyton): (a) Presumably Muenster (410 m.); (b) Frankfort-on-Main (gramophone records).
St. Elma: Prague.
Neutrudyne (Dorking): Either Barcelona (EAJ18) or Seville (EAJ17), but no programmes available.
Harmony Four (Harlesden): Yes, Zurich.
Neutrodyne (Acocks Green): (1) Elberfeld, relay of Muenster; (2) Dresden, relay of Leipzig.
Terror GIP: No estimated WL given, but possibly Muenster.
Twist (Kingston-on-Thames): Milan.
A.E.R. (Gloucester), Whitehates, 4 Valve (Crich), Night Searcher (Derby), J.W.V.C. (Retford), 3 Valver (Burnley), Noah (Ormesby), Spot (Bristol), Puzzled (Leigh, Lancs.), Sarbit (Swindon), Eglise (Stoke-on-Trent), Cleartorn: Frankfort-on-Main (gramophone records).
E.T.C. (Sheffield): Muenster.
Dee Bee (B’ham): (6/8) Frankfort-on-Main, (8/8) Prague.
Enquirer (Harrogate): (9/8) Frankfurt.
Straight Four (Manchester): (1) Breslau, relay of Berlin; (2) Frankfort-on-