Faavorita (Donizetti). 
Robinson (Bolton): (1) Possibly Stockholm; (2) 6MI amateur Douglas, (I.O.M.) or 6NI amateur, Bootle, Lancs. (3) Koenigsberg (English lesson).
J. U.B. (Bellingham): Kalundborg, relay of Copenhagen.
Det 2LF (Worthing): We suggest that you heard amateur transmissions, but cannot trace as you give no call signs.
Leonides (Harrow): (1) Yes, Huizen (Holland); (2) Norddeich (weather report).
Hillside (Bickley): Yes, quite possibly Luxemburg; details of programme not published.
N.C. Signals (York): Madrid (EAJ7) La Favorita (Donizetti).
Curious (Huddersfield): Apparently a U.S.A. station; possibly WGY (Schenectady), we cannot trace the relay.
Joe Soap (Guildford): PTT Lyon, relay from theatre or cabaret.
Wollacott (Kenley): Huizen (Holland) relaying sacred service from Evangelical Church at Amsterdam.
Novice (Stratford): Madrid (EAJ7) Opera, La Favorita (Donizetti).
Glennie (Bothwell): Yes, possibly Kharkov, relaying Moscow.
Caravan (Cosham): If you heard the words "Polskie Radio," then Warsaw ("Warszawa"), but did you hear this call?
Portland Bill (Portland): (1) No, WGY (Schenectady) direct, (2) cannot trace this relay, (3) no; (4) Aachen (Aix-la-Chapelle), (5) Cork, relaying Dublin.
Short Waves (Saddington): Cannot confirm, but possibly BDRA (Paderborn-Warschau).
Tidworth (Tidworth): (a) Cologne; (b) Aachen.
Amateur Searcher (Tunbridge Wells): If no 100 coil used, your W.L. is totally wrong, but if approximated W.L. given, possibly Kovno (Lithuania).
6 Barnard Road (Capham): Apparently Kalmar or Saeffle, relaying Stockholm.
Siewll (Westcliff): Milan.
Stevenson (Southsea): operetta from Teatro Milan, direct, or from Muenster; coupon must be sent with each enquiry.
Straight Four (Scarborough): Moscow Comintern (RDW).
Black Eagle (Hastings): Yes, WGY (Schenectady) direct.
Robinson (Spilsby): Would appear to be Berlin, testing, but cannot confirm; E.V.L.
St. Audrey's (Bournemouth): 2LI, amateur Southampton.
Knags (King's Lynn): Yes, WGY (Schenectady) direct.
Padre (Grays): Government wireless station at Mitcham.
Kingsteignton (Kingsteignton): Some estimation of W.L. must be given; regret, cannot trace. No coupon sent.
Miskinlte (Newport, I.O.W.): Madrid (EAJ7).
Quarlitur (Faine): The coacert was apparently from Leningrad, but the QSL was received from a wireless fog beacon; possibly Scilly Isles.
Safety (Bexhill): We know of no Scandinavian station giving such.