(b) about 458m.) not traceable; (c) An amateur.
Kitmacolm: Probably Malmoe 270m.
Coils: (a) Nov. 7, Marseille (P.T.T.) relaying Paris (P.T.T.); (b) Nov. 8, Petit Parisien, Cosmopolitan Radio Paris (P.T.T.), relayed by Lyon la Doua).
Short-Waver: Please send name and address.
Three Valves: E.A.J.4 Madrid (R. Castilla).
Clovelly: Stockholm.
Tony: Muenster.
Wavelength: Probably Stockholm.
Distodyne (Manchester): Malmoe relaying Stockholm.
Bonzo: Hamburg.
Electron: Bremen relaying Hamburg.
Mush: Probably Oslo.
Musicus: Malmoe or Goteborg.
5GB is B.B.C.-G.P.O. Chelmsford testing.
One-Valver: Nuremberg (341m.) relaying Munich.
Etherhog: E.A.J.4 Madrid (R. Castilla).
Leicester: Madrid (Castilla, E.A.J.4), 304m., or R. Barcelona (E.A.J.1).
Interested: Probably R. Toulouse (441m.).
Wand: Daventry.
Squarelaw: E.A.J.4 or E.A.J.6.
Pop: Probably R. Barcelona E.A.J.1 (325m).
Topples: Probably Radio Paris.
Another Amateur: Toulouse (doubtful).
Bernutrard: Not traceable.
Kaye Jaye: Portland, Oregon (K.G.W.), 491.5m.
R.D.C.: Probably Union Radio, Madrid (E.A.J.7).
J.E.W.: Not traceable on this wavelength.
Geebee: Probably Bilbao (E.A.J.11).
Puzzled (Leominster): Daventry relaying 2LO.
Spero: If time was a.m., Koenigs Wusterhausen.
W.W.W.: Not traceable.
Ecivon: Not sufficient details.
Gay Blondel: Nov. 7, Hilversum - Nov. 11th probably Radio Paris, but no time given.
Peter: Vague details, possibly Koenigsberg.
Enquirer: Munich, possibly.
Quisisana: Buda Pest.
Neutrodyne: Probably Hamburg.
Bert S.: Yes, quite likely Cadiz.
Searcher: your estimated wavelength very doubtful; certainly not Berlin.
Medicus: Possibly Helsingfors.