Wireless Willy: cannot trace, WL too vague.  
Reveal (Chiswick): Moscow (RDW).  
Holly (Cheshire): item not advertised, possibly Madrid (EAJ7).  
2 O.B.F. (Lincoln): Buda-Pesth.  
Amico: (1) Stuttgart, (2) Leipzig.  
Torbay: too vague, cannot trace.  
Bm/Baav: Frankfort-on-Main, relaying Berlin.  
A. W. Eenvalve (Bristol): Malmö (270 m.) relaying Stockholm.  
Von (Brighton): Breslau, relaying Berlin.  
Searcher (Manchester): Hamburg, relaying Hanover.  
Condenser (Derry): yes, Stuttgart (446 m.).  
Reflex Two: Newcastle.  
Tona-Three (Blackpool): Rome.  
Devo: possibly Moscow (RDW).  
Britannic (Bradford): (19) Prague and Brünn, (20) possibly Madrid (EAJ6).  
Williams (Mile End): (1) Hamburg, (2) Berlin.  
O-V-1 (N. 12): either Muenster or Stuttgart, both gave variety programmes.  
Griff Tredegar (S.W.): yes, Rome.  
X. Y. Z. (St. Leonards): not on 850 m.; Koenigswusterhausen on 1,300 m. at that time.  
13 D.D.:  if p.m. Hamburg relaying Hanover.  
Esprit de Corps (Pontrefact): cannot trace morse stations.  
Amplion (W. 10): if not Eiffel Tower, cannot trace.  
Embrayage: item not in programmes, but believe PTT, Paris.  
Iichfieldian outfits Barcelona (EAJ13), Vienna relaying Hanover.  
Anxious: too vague, cannot trace.  
Gorton: (1) Sorö, relay of Copenhagen, (2) possibly Klagenfurt testing (relaying Vienna), (3) must be Gothenberg, (4) Barcelona (EAJ1) 332 m.  
2 VHV: (36) yes, Stettin, relaying Berlin, (37) no, Barcelona (EAJ13).  
?Name (Cheltenham): R. E. G. (Bahama); Sale (3): Karlsborg, relay of Stockholm (altered programme).  
Slow Motion (N.W.2): L. G. K. (E.6); Gorton (5): a relay of Stockholm (altered programme).  
Icelandic: Reykjavik (Iceland); Brussels.  
P.O./0685: there is no transmitter at Greenwich Observatory.  
Harkatem (Oxford): (1) San Sebastian, (2) Prague, or Brunn.  
B.D.T. (Edinburgh): Cannot trace any French station on that WL.  
Secrecy: A relay of Stockholm, apparently Karlstadt on new WL.  
Pepper (Leicester): Zurich.  
Vodka: Too vague, cannot trace.  
Salcombe: Surely Daventry.  
Brenda: PTT, Lyons.  
E. Wiggall (Cheltenham): Madrid (EAJ7).  
E.D.E.S.; E.T. (Longton): Cockle (Bournemouth); Miller: Cranleigh: A relay of Stockholm (Altered programme).  
Poorie: Sorö, relaying Copenhagen.  
Bonzo: Cardiff (The Silent Fellowship).  
T.O.P. (Milford Haven): Karlsborg, relaying Stockholm.