thanks. Yes, WJZ (Boundbrook) relay of WGY.

Glavum (Gloucester): Madrid (EAJ6).

Swindon: Rome.

Bivalve 2: Cannot trace, but word Telegraphierat would be German, not Italian.

Tommy: (1) No estimated W.L. given.

Tiger Tim (Henley): Zurich (English Lesson).

J.L.S./36: Cannot trace.

F.C.H. (Bystock): Lyon-la-Doua, relay of PTT; (Vélodrome d'Hiver).

W. G. Gillott: (1) Cannot trace; (2) PTT, Paris.

Trio V Twil: Newcastle-on-Tyne.

Twicke: Muenster, relay of Foreign Stations.

Inquisitive (Scunthorpe): Hamburg, relay of Bremen.

Ebonite: Probably Seville (EAJ5).

Limp: (1) PTT Paris, or Lyons (relay).

Azure (Leeds): No coupon sent.

R.W.H. (Barnet): W.L. vague.

R.S.R. (Hampstead): Hilversum.

Stromboli (Mablethorpe): Hamburg.

Midget (Belfast): Hamburg.

Pepper (Leicester): Buda-Pesth.

A.W.L (Leicester): Hamburg.

Limp: (2) Bilbao.

Schol (Dunelm): San Sebastian, but W.L. very vague.

Clifford (Nottingham): Yes, presumably Prague.

H. B. D. (Dungannon): (1) Bremen, relay; (2) Hamburg; (2) PTT Toulouse, relay of Paris.

G. B. D. (Middlesb’ro): PTT Paris.

Beelzebub: Prague.

Chacko: Paris (Vélodrome d'Hiver, cycle races).

Petersfield: PTT, Toulouse, relay of probably Dortmund; request prog., no details published.

Primrose: Yes, J. S. (E 7.); Cadiz (375 m.).

Three of the Finest (Reading): (1) Radio Toulouse; (2) Hamburg; (3) PTT, Paris.

H.F. 42: Surely Dublin.

Feranti Federal (Welting): Breslau (Operatic overture evening).

G. H. B. D. (Dungannon): (1) British Amateur, cannot trace, (2) W.L. too vague.

S. L. B.: relay of PTT Paris (Vélodrome d'Hiver).

W. T. (Co. Durham): Ryvang, Copenhagen programme.

E. U. (Boreham Wood): presumably Madrid (EAJ6).

Genifer: Experimental station (Radio L.L., Paris).

Harmony 4 (Oxton): Munich.

Srauboj: Madrid (EAJ6).

Comrie: Muenster relay of foreign progs.

Neutrodyne: Vienna (Goethe evening).

F. R. (Fraserburgh): Hamburg relay of Hanover.

Wondering H. C. (Caddington): Madrid (EAJ7).

Chifos: Copenhagen (34.75 m.).

Winkie: PTT Paris (St. Quentin Carillon).

C/O. Ciney, Belgium: Poste de Saint Sebastian (346 m.).

Two-Valver (Belfast): Bilbao (EAJ11).

Marseilles (relay of PTT Paris).

Oddfellow: (1) Madrid EAJ7; (2) Yes, Glasgow (from St. Enoch's U. F. Church).

Bimmie (Derby): Madrid.