J.B.S.: (1) Elberfeld, relay of Muenster; (2) Sorö, relay of Copenhagen.
Osram D.E.R.: Details point to San Sebastian.
BM/EXQO: San Sebastian.
BM/FAAA: Cannot give address of amateurs.
Roy: (1) Cannot trace; (2) Madrid (EAJ7).
W.S.H. (Cambridge): Bremen, relay of Hamburg.
Wendy: Surely Radio Paris.
Ingeniere (Esher): Milan.
R.W. 9 (Eastleigh): Hilversum.
Dundarave: Breslau (418 m).
N.J.G. (Portsmouth): Eiffel Tower.
Felfoufor: Cannot trace.
Oxo: (1) Breslau, relay of Berlin; (2) Oslo.
HF (Marlboro'): British amateurs, cannot trace.
DE6 (Catford): Muenster, relay of Elberfeld.
Semper Paratus: Cannot trace unless Madrid (EAJ7).
F.L.B.C. (Kent): Frankfort-on-Main.
Transformer: presumably Dublin.
R.J.L. (Barking): Madrid (EAJ7).
J.W. (Armagh): Yes, amateur 6NI (Bootle).
Rheostat (Bath): Radio Toulouse.
Vulcan: Probably amateur.
Optimistic R 2: Moscow (RDW).
S.F. IIa: Details of WL too vague.
Coeur de Lion: (1) If no, cannot trace, if a.m. possibly Madrid (EAJ6). (2) PTT, Paris.
Loud Speaker (Hascombe): Lyons, relay of Paris.
Wave Twister (Middlesbrough): British amateur.
Oidar: Madrid (EAJ7).
H. Tucker: Radio Paris.
Trioni (Hastings): Berne.
Sparks (Hull): Yes, amateur.
Radio (Barrow): Breslau, relay of Berlin.
Nob (Little Ilford): Oslo.
Coil Pusher: (1) Cadiz (EAJ3); (2) Oslo.
Long Distance: (1) Cadiz (EAJ3), (2) Cadiz (EAJ3).
Lurgan: Madrid (EAJ7).
Archie (Broadway-Worcs.): (11/4) possibly San Sebastian, not in programmes; (14/4) Madrid (EAJ6).
Univerfier: Radio Paris testing.
Mr. Eastwick (Enfield): Probably 5XN, British amateur (Eltham).
Neutrophase IV (Birmingham): (1) Hamburg, ex Café Continental (Hanover), (2) Cadiz (EAJ3) experimental transmission (3) no, probably new Warsaw station (4) Yes, Dublin (5) Dublin Richard III., Act I., Scene 2); (6) Barcelona (EAJ1); (7) Elberfeld relaying Dortmund (lecture by Frau Aenne Schulz-Blensdorf).
Whatisit: No details of programme given, presumably Muenster (talk).
Searcher (Paignton): Oslo (news).
I Guess (Maesteg): Madrid (EAJ7).
Univalve: British amateurs, cannot trace.
Paddy (Clonmel): (a) presumably PTT, Paris; (b) if 4.45 p.m. Breslau.
Peeping Tom: British amateur, cannot trace.
F.G.L. (Nottingham): possibly Frankfort-on-Main, no detailed programme available.