Radio-Fan: 5BC British amateur (Herts).
Yan: cannot say, 6TY or 6GY?
J. F. (Coventry): 6NI amateur (Bootle).
R. A. I. (Colchester): difficult to say, WHT (Chicago).
WJY (New York), WGY (Schenectady).
Bonzo: WGY (Schenectady).
Anxious (Birmingham): Madrid (EAJ7).
Not a Hope: Hamburg.
Shadwell Twin: Stockholm.
Super Three: British amateur, cannot trace.
Ultradino (Spain): Prague.
Resistoflex.: cannot trace, Continental relay of Daventry.
I. B. V. (Bristol): Hamburg.
Canterburyian: Swedish relay of PTT (Paris).
J. R. V. (Manor Park): Lyons relay of FPTT (Paris).
Antrobus: Hamburg.
Red Dragon: cannot trace; 2BC?
Squeak: Madrid (EAJ6).
Vier Valves: probably harmonic of 5XX.
Rheostat.: too vague.
Four Valve (Ashburton): (1) Nuremberg, (2) Madrid (EAJ7).
X. L.: presumably Leeds or Liverpool.
Battery Bill (Leeds): Madrid (EAJ6).
Radsup: is W.L. correct?
surely PTT (Paris).
Diamond: Hamburg Opera: The Dead Eyes.
Sparks (Eastbourne): no given, if p.m. Radio Paris.
Kansas (Hampstead): Berne.
Gat (Leicester): Berne (Boy Scouts).
Amplion (Rock Ferry): Reciting; touchdown (fighting lesson).
WAJ. B. (Bedford): Time apparently wrong, but 6.55 a.m. would be Hanover.
J. C. M. L. (Ilkeston): Rome.
Clearton: Radio Lyon.
North East: Surely amateur.
Find the Villain (Beaulieu, Hants): Berne.
Ex-op.: Canadian or U.S.A. station.
Rainy Day: Eiffel Tower.
Knob Twister (Worcester): (13/1) cannot trace, (2.45 a.m.) presumably U.S.A., (2.30 a.m.) U.S.A. station.
Morrite (Huddersfield): British amateur, cannot trace.
V2 Timperley (Cheshire): Barcelona (EAJ13).
Coil: Berlin.
H. F. H. (Hoddesdon): (a) no, W.L. wrong, (b) presumably Oslo, items not advertised.
Amon-Ra: cannot trace, believe Malmö or Gothenburg.
E. L. W.: (15/1) Hamburg; gong; not necessarily when dance music, (3.15) Berne (Switzerland) gong has now been abolished, (3.40) probably Hilversum, but item not advertised.
R. B. (Leicester): Hanover.
Johnny: too vague.
P. V. (Peterboro'): W.L. vague, either Oslo or Hamburg.
Rover: Cardiff.
Liverbird (6LV): cannot trace.
Unif Set: Geneva testing.
Rex: W.L. wrong, cannot trace.
Kingston (Hull): New Prague station.
Hamptonian: San Sebastian.
Neutro (Bristol): not advertised testing; presumably Cadiz (test).
Central (Halifax): Prague testing.
Bright: L.42914: not advertised, probably Koenigs-wusterhausen.
J. H. C. (Dover): extended transmission Madrid (EAJ7).
N. A. B.: Bremen.
H. G. (Newton Abbot): not advertised, probably Prague.
Tariff (Newton Abbott): San Sebastian.
Australia (Cheshire): not advertised, probably Prague.
Orange: Children’s Hour, Hamburg.
Plug and Socket: details too vague.
R. S. B. (Uplands): Prague.
Hones: OXO (Stafford): Prague.
Dannesis: (1) Hamburg, (2) Bergen testing, (3) Prague, (4) too vague.
Teignmouth: published this week.
Ear-ache: cannot trace item, not German.
Eh What? (Swansea): Hjorring.
Sterling: Moscow (RDW).
Mechelin: (7.30) relay of Stockholm.
XL60R: item not advertised.
L. G. L. Hoiser: a.m. or p.m. Jawood: Berlin (305 m.).
Quixotic: Hanover.
G. S. B.: WGY, Schenectady.
Beach (Dover): probably Breslau.
Veraphone: Berlin (576 m.).
L. E. B. (Leeds): Berlin (1300 m.).
L.405805: Koenigs-wusterhausen.
L. A. W. M. A.: probably WGY, Schenectady.
Rex: what language?
Toc.P.P. (Woolton): W.L. vague, presumably Hamburg.
Ficolax: probably B.B.C., not advertised.
Radio Rex (Bradford): presumably amateur.
J. O. R. (Lidlington): vague, perhaps Nuremberg.
Actina: San Sebastian.
P. T. T. (Holloway): presumably PTT Toulouse (280 m.).
C. C. C. (Leeds): cannot trace, possibly WGBS (New York).
Stylo: a.m. or p.m.
Edinburgh 11a: yes, Hamburg.
Batteries (Norwich): Radio Paris (test).
Second Detector: Hamburg.
King: Stoke-on-Trent (306 m.).
E. H. (Syston): WGY (Schenectady).
EWA (Watford): (1) probably Montpellier relay of Radio Toulouse: (2) item was advertised, probably German translation.
Bannock: Berlin (1300 m.).
St. Peter Port: Cardiff.
S. E. C.: no W.L. given.
Shoeburyness (Three Valver): Madrid (EAJ7).
Night-Fan: Basta.
Prague.
Toby: Eiffel Tower, yes.
FPTT (Paris).
W. S. H.: yes, Moscow (RDW).
Eric:(Birmingham): details rather vague, Cadiz (EAJ3).  
Straight 8: Cassel relaying Frankfort-on-Main.  
Up Late (Edinburgh): probably KGO (Oakland).  
Fiddlesticks in Training: Prague.  
Treffynnon: Madrid (EAJ7) (Anderson’s).  
Bassoon: presumably 2XAF (Schenectady N.J.).  
J.S.K.S.: probably Brussels.  
W.R.P. (Newport): cannot trace.  
Miffy (Thornaby): San Sebastian.  
Dorothy: Berne.
Triotron (Blackburn): Vienna.  
Dinkie (Bolton): Oslo.  
Ideal (St. Helens): (a) too vague, (b) Hamburg.  
Weller (Eastbourne): British amateur (Weybridge).  
Laurelbank (Patcham): (16/1) cannot trace on that wave band if a.m. (15/1) if p.m. Barcelona (EAJ13).  
I.X.L.: probably WGY (Schenectady).  
Coachman: Prague.  
N.E.T. (Loughton): Cannot trace on that W.L.  
Happy (Huddersfield): Madrid (EAJ7).  
R.I.P.: Berlin (1300 m.) probably San Sebastian.  
Acid (Berwick-on-Tweed): Rome.  
Dicky (Highgate): Prague or Madrid (EAJ7).  
X.V.X.: cannot trace.  
Blackpool: San Sebastian.  
Sunny Jim (Barnet): Prague.  
Ether (Gillingham): Prague.  
P.Q.D.: surely Hamburg (329 m.).  
Valve (Folkestone): Berlin.  
E.M.P. (1) Madrid (EAJ7), (2–3) not yet obtainable.  
Twinkle (Glasgow): Probably Gothenburg or Prague.  
Syndicate (Glasgow): Probably Gothenburg or Prague.  
Straight Five (Birmingham): (1) Not advertised; undoubtedly B.B.C. station; (2) w.l. wrong, presumably San Sebastian; (3) Seville (EAJ5); (4) most certainly Norddeich (weather report).  
Kew (Dewsbury): Madrid (EAJ7); Jan. 17) Hamburg.  
2 Valves (West Smethwick): (Piano solo) details too vague; Prague or Madrid (EAJ7) (faint music) rather too vague.  
Polly Holly (Belfast): Probably KDKA (East Pittsburg) 309 m.  
Hypo (Penryn): Madrid (EAJ4).  
E.U. (Boreham Wood): Madrid (EAJ7).  
Peaca (Barnoldswick): Barcelona (EAJ13).  
Big Four (42BL Atherton): Cadiz (no relay).  
One Valve: San Sebastian (EAJ8).  
Hamburg.  
Hew/Mar (Lowestoft): Madrid (EAJ7).  
Recipio (2nd): If outside broadcast, could only be Barcelona EAJ13.  
Croxtonian (Southport): San Sebastian (EAJ8).  
Tired Tim: Not advertised; (b) a.m. or p.m.; Violet (Lowestoft) Hamburg.  
H.M.B. (Sheffield): Cannot trace on that w.l.  
Four Valver (Basingstoke): (a) Too vague; (a) San Sebastian; (c) Barcelona (EAJ13).  
Pom-Pom (Prestwich): Relay of Stockholm.
Venus: Cannot trace on that w.l.
Brighton: Madrid (EAJ7).
Ailsa (Ayr): Madrid (EAJ7).
Brin Mosso: (a) Old) cannot trace; (Austrian National Anthem (operator’s message)). Marie (Bolton): San Sebastian (EJAJ8). Madrid EAJ7. Eitra4 (Grazeed)(Cardiff).
Cossor (Birmingham): Berlin (Carbaret).
Phil (Northampton): Presumably an amateur.
Ether Hunter (Honiton): Prague (new station).
Andrew (W.5): San Sebastian (EAJ8).
Norman (Bolton): Spinner.
DX06 (Manchester): Madrid (FAJ7).
Patia: Berlin (1300 m).
Farmer: Buda-Pesth.
Twin Valve: Muenster (410 m).
Northey: (a) Berlin, (2) probably Bremen, (3) relay of Hamburg.
Yeadonite: Buda-Pesth.
Oiler: Hamburg.
Ashdown (Rugby): (a) Breslau, (b) Rome.
Jocelyn: Too vague.
(Belgium): Berne.
Aycheff: Cannot trace on that w.l., but at that time Madrid (EAJ7), and Prague (368 m).
Nob (Little Ilford): Prague.
Singvono (Swavese): Probably KDKA (309 m).
O.S.B. (Netherton): Buda-Pesth.
Cadley (Fulwood): Koenigswusterhausen (German National Anthem).
Edwards (Devon): (a) Madrid (EAJ7) (b) Surely San Sebastian (EAJ8).
Reflex: Cadiz (E.A.J. 2 J.E.J. (Bristol): Hamburg.
Flewelling (Cardiff): Probably Bergen.
Secat: Berne.
Coil Holder: EAJ22 or EAJ5.
Dusty: Hamburg.
Accra: No coupon, Prague (368 m).