Radio-Fan: 5BC British amateur (Herts).
Yan: cannot say, 6TY or 6GY?
J. F. (Coventry): 6NI amateur (Bootle).
R. A. I. (Colchester): difficult to say, WHT (Chicago).
WJY (New York), WGY (Schenectady).
Bonzo: WGY (Schenectady).
Anxious (Birmingham): Madrid (EAJ7).
Not a Hope: Hamburg.
Shadwell Twin: Stockholm.
Super Three: British amateur, cannot trace.
Ultradino (Spain): Prague.
Resistoflex.: cannot trace, Continental relay of Daventry.
I. B. V. (Bristol): Hamburg.
Canterburyian: Swedish relay of PTT (Paris).
J. R. V. (Manor Park): Lyons relay of FPTT (Paris).
Antrobus: Hamburg.
Red Dragon: cannot trace; 2BC?
Squeak: Madrid (EAJ6).
Vier Valves: probably harmonic of 5XX.
Rheostat.: too vague.
Four Valve (Ashburton): (1) Nuremberg, (2) Madrid (EAJ7).
X. L.: presumably Leeds or Liverpool.
Battery Bill (Leeds): Madrid (EAJ6).
Radsup: is W.L. correct?
surely PTT (Paris).
Diamond: Hamburg Opera: The Dead Eyes.
Sparks (Eastbourne): no given, if p.m. Radio Paris.
Kansas (Hampstead): Berne.
Gat (Leicester): Berne (Boy Scouts).
Amplion (Rock Ferry): Reciting; touchdown (fighting lesson).
WAJ. B. (Bedford): Time apparently wrong, but 6.55 a.m. would be Hanover.
J. C. M. L. (Ilkeston): Rome.
Clearton: Radio Lyon.
North East: Surely amateur.
Find the Villain (Beaulieu, Hants): Berne.
Ex-op.: Canadian or U.S.A. station.
Rainy Day: Eiffel Tower.
Knob Twister (Worcester): (13/1) cannot trace, (2.45 a.m.) presumably U.S.A., (2.30 a.m.) U.S.A. station.
Morrite (Huddersfield): British amateur, cannot trace.
V2 Timperley (Cheshire): Barcelona (EAJ13).
Coil: Berlin.
H. F. H. (Hoddesdon): (a) no, W.L. wrong, (b) presumably Oslo, items not advertised.
Amon-Ra: cannot trace, believe Malm√∂ or Gothenburg.
E. L. W.: (15/1) Hamburg; gong; not necessarily when dance music, (3.15) Berne (Switzerland) gong has now been abolished, (3.40) probably Hilversum, but item not advertised.
R. B. (Leicester): Hanover.
Johnny: too vague.
P. V. (Peterboro'): W.L. vague, either Oslo or Hamburg.
Rover: Cardiff.
Liverbird (6LV): cannot trace.
Unif Set: Geneva testing.
Rex: W.L. wrong, cannot trace.
Kingston (Hull): New Prague station.
Hamptonian: San Sebastian.
Neutro (Bristol): not advertised testing; presumably Cadiz (test).
Central (Halifax): Prague.