Iwannaknow: Cardiff.
Powerful Three (Wood Green): Buda-Pesth.
1 Valve (Fakenham): Zurich.
2 Valver (Eversham): Amateur, cannot trace.
Valves Four: Vienna (Twilight of the Gods, 8 p.m.).
G. B. (Grimsby): Radio-Luxemburg.
Ea Wells: (1) Berlin, (2) Zurich, (3) Vienna (Twilight of the Gods).
Wiggs: Presumably Radio-Luxemburg, no programmes available.
Perrous: Was not this San Sebastian? Know of no station working in Portugal.
Ande (Otley): Not in programmes, possibly Belgrade.
Saucepan (Llanelly): Probably Seville (EAJ5), PTT, Lyons.
W. D. (Redditch): 60Y amateur (Golders Green, N.W.11).
Twin Valve (Northampton): 2CW amateur (Bath), 2GW amateur (Cheshire).
G. B. M.: Brünn.
Blase Bill: Probably Stockholm.
Francaise: No. PTT Paris relaying the Vélodrome d’Hiver (6 days’ cycle race).
G. H. C. (Berne): Stuttgart.
Reinartz 3 (Heckham): Moscow (RDW).
C. E. Tottle: (2) Probably PTT, Bordeaux testing, (1) Dublin.
Lilian: Can trace no station with this call sign, probably amateur.
Ovi: Yes, Koenigsberg (operetta).
G. S. (Norwich): Barcelona (EAJ12). Finds deal of trace, presumably.
Cole: Bilbao.
L. 429141: Karlsborg, relay of Stockholm.
5MN (Wigan): Yes, Radio-Toulouse relay.
Alexandra (Hull): No indication of W/L given, cannot trace.
Fido (Devizes): Cannot trace.
Coil Pusher: (a) Cassel, relay of Frankfort, (b) Stettin, relay of Berlin.
Low Waves: (1) Bremen, relay of Hanover, (2) Yes, Kiel, relay of Hamburg.
BM/BBWS: Madrid (EAJ7).
Cameron (Lochiel): (a) Madrid (EAJ7), (b) Hamburg (operetta).
E. A. W. (Earls Court): Cannot trace.
Spero (Glasgow): Frankfort-on-Main, (interval signal:  F).
S. B. Loud-Speaker (Edinburgh): Cannot trace item in programmes.
Benson (Wallingford): Hamburg.
L. P. H.: (1) Yes, presumably extended programme, Berne, not advertised, (2) Oslo.
Russ (Plymouth): Surely Berlin.
A. E. G. (Earlsfield): Radio-Toulouse.
Ultra-Crystal (Colchester): Radio L.L. Paris.
Neutrophase IV: (1) Radio-Belgique always gives call sign, probably PTT Toulouse, (2) Yes, Breslau, relay of Berlin.
3 D. E. R.’s: Presumably WGY (Schenectady).
M.81: PTT, Paris, relay of Vélodrome d’Hiver.
Heswall: Probably Dublin.
Cosmos Amplion: Probably PTT, Bordeaux.
Osmosis: Cannot remember. Madrid (EAJ7).
Cameron (Lochiel): (a) Madrid (EAJ7), (b) Hamburg (operetta).
E. A. W. (Earls Court): Cannot trace.
Spero (Glasgow): Frankfort-on-Main, (interval signal:  F).
S. B. Loud-Speaker (Edinburgh): Cannot trace item in programmes.
Benson (Wallingford): Hamburg.
L. P. H.: (1) Yes, presumably extended programme, Berne, not advertised, (2) Oslo.
Russ (Plymouth): Surely Berlin.
A. E. G. (Earlsfield): Radio-Toulouse.
Ultra-Crystal (Colchester): Radio L.L. Paris.
Neutrophase IV: (1) Radio-Belgique always gives call sign; probably PTT Toulouse, (2) Yes, Breslau, relay of Berlin.
3 D. E. R. S: Presumably WGY (Schenectady).
M 81: PTT, Paris, relay of Vélodrome d’Hiver.
Heswall: Probably Dublin.
Cosmos Amplion (Rochdale): Cannot trace Morse stations.
Midnight (Chorley): Madrid (EAJ7). XX. Berlin (1300 m).
Devon Coast: No, Madrid (EAJ7).
Electrician (Dorking): W.T. too vague cannot trace.
Nosey (Swindon): (8 p.m.) Prague, (8.40) if in German, Hamburg.
D. E. Benson: Presumably Radio-Paris.
Frame Aerial: (1) Vienna (Galsworthy’s Windows), (2) Buda-Pesth (“Zigagne music).
Felix (Felixstowe): Are you sure this was not Hilversum?
Pat (East Leicester): Hamburg.
Joey (Rochdale): Cannot trace interference.
2VHV: (12) cannot trace, (13) Rome, (14) Brussels, (15) was this not Toulouse, (430 m.)?
Grid Leak (Leicester): Cassel, relay of Frankfort.
Franco (Burnley): (1) Probably relay of Copenhagen, (2) Probably amateur.
Ticus: If W.L. correct must be Oslo.
Roller (Holmes): Swansea, relay of Cardiff.
Kidney: Was not this Cardiff?
M. E. W. (Spalding): (1) Amateur, cannot trace, (2) PTT, Paris, (Vélodrome d’Hiver).
F. C. Mansfield (Notts.): Cannot trace.
P. J. L. (Newcastle-on-Tyne): Berne.
Midget (Plumstead): Bilbao.
Student (Maesteg): Hamburg.
Kid Boots: Radio-Toulouse.
Lex (Newcastle-on-Tyne): Breslau, relay of Berlin.
Shinner (Southampton): (1) Cannot trace test, (2) Madrid (EAJ6).
L. W. F. (Clapham): Hilversum.
R. J. Fife: Barcelona (EAJ1).
Iberica: (1.40 a.m.) either U.S.A. or PTT Toulouse, relaying Paris relay of Vélodrome d’Hiver. (8.30 p.m.) Bruinn.
Crab: Swansea, relay of Cardiff.
Sago (Dublin): Probably Barcelona (EAJ1).
Puzzled: (1) 2.5 a.m. then Moscow.
W. K. L. L. (Wylde Green): (1) Breslau, relay of Berlin, (2) Vienna.
Fiddler (Bedford): Marseilles, relay of PTT, Paris.
Melville (Fishponds): PTT, relay (Vélodrome d’Hiver).
RTZ/O.V.O./J.W.F. (Harrogate): PTT’s (Paris), relay of 6 days’ cycle race (Vélodrome d’Hiver).
Royalty: Madrid (EAJ6).
A. B. C. (Nottingham): Seville (EAJ5).
2 V (Deal): Hilversum.
Harmony (Essex): Hanover, relay of Hamburg.
224A: Breslau.
Sans Fil: Breslau, relay of Berlin.
T. W. R. (Ipswich): San Sebastian.
L. W. L. P. Z.: Lyons, relay of PTT, Paris (Vélodrome d’Hiver).
Twin-Valve (Fulham): Hilversum.
Arol: (8/4) Koenigswusterhausen, (11/4) Breslau, relay of Berlin.
Amico: Karlsborg, relay of Stockholm (concert hall).
H. Osborn (Cambridge): Madrid (EAJ6).
Polar (Harrogate): Lyons, relay of PTT.
Britannic (Bradford): San Sebastian.
T. S.: Radio-Toulouse.
T. N. W. (Bangor): (1A) Prague, (2a) Madrid (EAJ7).
Evan Owen (South Carnarvonshire): 5 B, amateur (Lancaster), 6NIF, amateur, cannot trace.
Bognor: (1) San Sebastian, (2) Prague.
Archie (Broadway, Worcs.): No W.L. stated, nd coupon.
C. C. F. (Hockley): No time stated, send further details.
OPPWCH (Kenfig Hill): Presumably WGY (Schenectady).
H. Edwards (Bristol): (1) Zurich (513 m.), (2) Barcelona (EAJ13).
Coosha: Oslo.
Ray (Surrey): (a) Berne, (b) Sorö, relay of Copenhagen, (c) Hilversum.
Nugget (Redditch): Regret cannot trace address.
Duo: PTT Paris (Vélodrome d’Hiver). Presumably Dublin.
Nedirb: Rome.
Transfive: Breslau, relay of Berlin.
Chemico: Berlin (1300 m.).
Snooks: Cassel, relay of Frankfort.
J. L.: Madrid (EAJ7).
M. N. T. F.: Plymouth or Bradford.
Condenser Twirler: Oslo.
J. P. H. W. (Studland): Amateur transmission.
Sterling (Redhill): Details too vague, Stuttgart or Leipzig.
O.V.1: For PTT Lyons as “wait” signal in morse; (6) Cassel relay of Frankfort.
No Namo (370 m.): Prague.
Mac (Burscough): PTT, Toulouse.
Leddy: Test transmission Bordeaux.
PPV4: Bilbao (EAJ11).
Home Made 2 (Wimbledon): A relay of Stockholm.
Trigon: Sorö, relaying Copenhagen Clock.
Coeur-de-Lion: (1) Barcelona or Seville, (2) Sorö.
No Name: La Riva, (B) Seville, (A) too vague a relay of Hamburg.
Alert (Coventry): High power station Hilversum testing.
Eff See (Ashford): Cannot trace 1 and 2, (3) Berlin.
Knob-Turner (Westgate): Too vague, cannot trace.
Super Three (Aldershot): Possibly KGO.
Homemade Twin (Newhaven): Yes, Hamburg.
Featherstone (Cheltenham): Your indications of wavelength are too vague; cannot trace transmissions by this means.
Puzzled (Ahascragh): Hamburg (dialect play).
Kincaid (Leek): Details do not agree.
Hopwood 1 Valve (Southampton): Barcelona EAJ13.
Topsy: Wavelength wrong; details tally with Berlin.
Spero Mellora: Possibly Canadian station.
Stour (Stourbridge): Hilversum testing on high power.
PCBW (Tuxford): Hilversum.
Reinartz 4 HH: No coupon.
Loco (Holy Island): Wavelength must be wrong, cannot trace lady announcer at that time.
Wave-Catcher: (1) Koenigs Wusterhausen (Press), (2) Rome, (3) Radio-Toulouse, (4) Muenster, (5) Bremen.