Snatcher: Cannot trace.

F. C. H. (Edmonton): Radio Paris (special Exhibition transmission).

Raingo: Cannot trace, possibly Pittsburg (461 m.), Los Angeles (468 m.), or Washington (469 m.), or amateur (gramophone records).

Gault: W.L. too vague, cannot trace.

Southampton: Radio Paris (special Exhibition transmission).

Kissmequickandletmego: presumably Moscow (Popoff station).

Purple Shade: W.L. too vague, possibly Frankfort-on-Main (gramophone records).

Twin (Forest Gate): Radio Paris.

No Name (Putney): 50X, amateur.

Rondalyn (Manchester): Nuremberg, relaying Munich.

Coil Pusher: (10) amateur transmission, (12) Oslo.

Adsum: Yes, Prague.

A. J. (Stockport): no estimated W.L. given, cannot trace.

Ether (Gillingham): Warsaw.

Tuba (N. 3): Hilversum.

Morse Worshipper: cannot trace, probably amateur station testing.

Q. R. A. (Notts): Madrid (EAJ7).

4 Valve Set (Leeds): Radio Paris (special Exhibition transmission).

City Youth: cannot trace - not a European station.

S. W. 11 (Liverpool): Moscow (RDW).

Ello: Cannot trace in any programme.

Fido (Streatham): not advertised, possibly Breslau.

Terminal (Ewell): Warsaw.

A. W. (Witton): too vague, cannot trace.

Q. R. A. (Bromley): not item in programme, possibly Bilbao (EAJ9).

F. W. (Kent): (1) Hamburg; (2) Prague.

F. W. (Tyneside): Moscow (RDW).

Oosaat (Lancashire): Oslo.

H. Tucker: Yes, Sherlock, it was Dublin!

R. F. (Burton): Amateur transmission.

Ether Comber: Leipzig (reading from Stephen Leacockâ€™s humorous works).

Tell Me (Brecon): No W.L. indicated, but without doubt an experimental amateur.

J.T. (Dublin): Norddeich (weather report - and news).

Sparker (Glasgow): Brunn (Radio Journal, Brno).

Dorn (Glasgow) (4): Rome, relay from a theatre.

8 Valve (Redhill): Berne.

A.G. 12 (West Hartlepool): (1) Vague possibly Prague, (2) W.L. wrong and details too vague - cannot trace.

Togo II (Portsmouth): Madrid (EAJ 7), relay from Ice Palace.

Old World Two (Newquay): You do not state time, but this was Malmo relaying English lesson from Stockholm.

Aleph (Bolton): Berlin.

Doctor (Inverness): Moscow (RDW).

Wickersham (Horsham): (4) Petit Parisien, Paris; (5) Naples testing.

Swedish Listener (Ystad, Sweden): Prague, then testing on 395.8 m.

Name: (English talk on business letters), Hamburg.

Syperhet: Cannot trace.

Solo (Sheffield): Your estimation of W.L. is too vague - either Bilbao or Barcelona (EAJ 13).