Squarelaw: 29th, 30th, Hamburg.  
Karachi: Madrid (Union Radio).  
Ponty: PTT (Paris).  
H.F. Crystal: (29th) Leipzig.  

S.R.B.B.: Hamburg.  

I.S. (Oxford): Cannot trace, unless extra from Eiffel Tower.  

All Concert: PTT (Paris).  

Archer: (27th) Barcelona (EAJ13).  

Faistaff: Berne.  

Two Valves (West Smethwick): W.L. too vague â€“ any German station.  

Optimist: What time?  

H.F. Crystal: (26th) Probably Karlsborg.  

Archer: (1) Atlantic City (N.J.), 275 m. (500 w.). (2) WJAR. Providence (Radio-Iberica), 305.9 m. (500 w.).  

Inquisitive: San Sebastian. 

C.S.H. (Bromley): Cannot trace WIAK.  

Cela (Leicester): Hamburg.  

B.M./WW20D: San Sebastian.  

Thanks: Copenhagen.  

Larden: (a) Radio Toulouse, (b) no coupon.  

Uniast: Probably Berne.  

V.C.H.: Probably San Sebastian.  

4 Valves: Hamburg, W.L. rather indefinite.  

C.A.V.: Muenster.  

J.W.L.: Hamburg.  

L.B. (Hove): Hamburg.  

J.H.T. (Cleethorpes): Probably Karlsborg.  

J.C. (Bolton): Hanover.  

Tiffany (West Garforth): A Leeds amateur.  

Kitbrew: San Sebastian.  

Live Wire: Stockholm via Malmo.  

Swanee: Hamburg.  

C.A. (Falmouth): Hamburg.

Caliban: Hanover.  

F.P.M.: Probably Radio Madrid.  

K.C.: (East Boldon): Hanover (269 m.).  

Eady: Hanover (269 m.).  

Kingfaylg: If German, probably Breslau.  

Ghent: Not advertised, apparently relay of Stockholm.  

Double Chance: (1st) Cannot trace; would appear to be Oslo; (4th) probably Eiffel Tower.  

Mac: Insufficient details, probably Hamburg.  

D.W.O.: (3rd) Berlin (1,300 m.) any night, Lyons.  

Jones: Berlin (1,300 m.).  

Relay: Bilbao (EAJ 11).  

Fluke: Madrid (Radio-Iberica).  

Doubleyou: Possibly Graz (392 m.), not advd. in programme.  

G.H.Q.: Bremen.  

Clay (Peterborough): W.L. wrong, must have been Koenigswusterhausen relaying Berlin.  

Excel: W.L. and call-sign wrong.  
