Lutheran: If 1,650 m., HFF (Belgrade), but more probably Koenigs Wusterhausen (2,525 m.); Wolff's Bureau (Press news); T.B.P. (Blackheath); Madrid (EAJ4)

Switz: 1,680 m. Aviation route reports.

Loud-Speaker: Probably amateur.

Juicy: Radio Berne.

James: Barcelona (EAJ1).

Mutvie: WBZ, Springfield, (Mass.), 333 m; KDKA, Pittsburg (Pa.), 309 m.

Pip: Berlin (Tannhauser).

H.F.D.E.T.L.F.: San Sebastian.

Clock: Probably Hamburg (EAJ18 and 21 not working).

Reachert Out: (Glasgow) no Koenigs Wusterhausen, cannot trace Hamburg.

Excel: Cannot trace.

Prento: (Leeds): Probably Hanover.

Peahen: O.W.L.

Head In: Hamburg.

T.R. (Aberdeen): Norddeich.

Inter Nos: Schenectady (N.Y.) 379.5 m.

C.E.P.: Cannot trace.

Oidar: Hamburg (397 m.).

Tropadyne: Elberfeld.

A Bunny: Probably Radio Berne.

Snowflake: Malmo.

H.L. (Kensington): Lyon PTT (Paris) relaying Paris.

Bonzo: Lyon PTT relay of Paris.

Mac: If a.m., cannot trace.

Enquirer (Harrogate): If 1 p.m., Zurich.

Early Hours: Cannot trace, but American station.

Nonpareil: British Station.

Pica: No estimated W.L., given.

Lauriston: Could only have been Hamburg.

Pontiff (Pontypool): 390 m. Hamburg, 350 m. no coupon.
 
Melvin Neath: Scanty detail, but probably W.B.Z. (Zee) Springfield (Mass.).

Amateur (Dublin): Probably W.O.R., Newark (N.J.).

Anxious (Glasgow): Probably either W.G.Y. (Schenectady) or W.O.R. (Newark).

E.R. Phone (Northampton): Barcelona (EAJ1).

Speed King: San Sebastian.

W.N.B., H.McK: Probably Malmo.

F.P.B.: Probably U.S.A. station.

Grid Leak (Bristol): Possibly Vienna.

H.K.S.: PTT (Paris).