Toulouse.

Squarelaw: Probably Cardiff.

Omo: Presumably Hanover.

Supersonic: Cardiff.

S.V.R.: Cannot trace, but presume Moscow.

Bonrose: Scanty detail, probably San Sebastian.

Sevhet: Seville.

Mack: Hamburg, vi Hanover.

W.W.N.: Bremen and Hanover relaying Hamburg.

Sopharn: Spanish station, but insufficient detail.

Kilmeny and Shutlo: San Sebastian.

Sevhet: Probably Berne.

E.J.W. (Birmingham): Probably Hamburg.

Three-Valver: Hamburg.

Imp: Brussels.

Crystal: Oslo.

AJS4: (a) Hamburg, (b) Dresden.

Ex Neutrodyne: Possibly Bilbao (EAJ9).

Reflex and Left Hand: Presumably a British station.

C.F.R. (Bolton): Cannot trace, but possibly Moscow.

S.N.C. (Seaham): Madrid (Radio Iberica).

Enquirer (Harrogate): Insufficient detail.

Crystovox: Probably Radio Toulouse.

Wavelength: Untraceable on this W.I., perhaps Nuremberg.

Accumulator: Probably Hamburg.

Cavalier: Bremen.

Norman Conquest: Eiffel Tower (2,650).

D.x. Fisherman: Madrid (Union Radio).

Enthusiast: Hilversum.

J.B.S.: Helsingfors.

Chitos: Insufficient detail.

Detector: (1) Probably Seville, (2) coupon required.

X.Y.Z.: Believe Eiffel Tower.

H.T. Avenue (Leeds): Radio Toulouse.

Three-Valver: Eiffel Tower.

B.T.H.: Insufficient detail.

Ilfracombe: Probably Barcelona.

Pandora: Frankfurt.

A.B.C.: Presumably Malmoe or Gothenburg.

Tapit: Madrid (Union Radio).

Please Donâ€™t Do It: PTT (Paris).

Ahab: If call-sign correct, Madrid (Radio Castilla).

Wor Thing: Koenigsusterhausen (2525 m).

Edinaber: Radio Toulouse.

Draper: Koenigsusterhausen, relaying Berlin.

H.J.R.: Probably Madrid (Union Radio).

5 Tube: Cannot trace.

Heterodyne: Radio Toulouse.

Neolith: Hilversum.

Chakophone: San Sebastian.

Jenifer: Probably Cadiz EAJ3 (360 m.).

Mac: Untraceable by details given November 23rd, Barcelona (EAJ1).

Star: Most certainly Canadian or U.S.A. station, but cannot trace.

J.G.: Probably U.S.A. station, cannot trace.

Seeker: Madrid (Union Radio).

Radion: Eiffel Tower.

Trusty (Derby): 22/11, Nuremberg; further coupon required.

Loup: Presumably relay of Stockholm.

Grove (Acton): Cannot trace.

Crystal (Lincoln): Copenhagen.

X.Y.Z. (Liverpool): Probably Hanover (296 m).

One Reflex: San Sebastian.

Swedish Listener: PTT (Paris), presumably through Marseilles.

Amplion (Liverpool): (a) Copenhagen; (d) San Sebastian, (c) Muenster, (b) no coupon.

Under (Sturminster): Radio