Unidyne (Sturminster): Radio Toulouse. 
L.G.K. (E.6): Hamburg. 
Suspicious (Oxford): Except Malmoe cannot trace. 
Ultraudain: Probably Berne. 
Recidivus V: Undoubtedly WGY (Schenectady). 
Cepnos, Cockaday, Yankalilla: Hamburg. 
Wander Plug: Stuttgart. 
2 Arz, Oscillator, Super-Het: Hamburg. 
Bath: PTT (Paris). 
VHP (Colchester): Berne. 
Boxer: No coupon. 
60 Volt: No coupon. 
Clough: Hamburg, via Bremen. 
S.O.S. (Chesham): Radio Berne. 
Howardian: (1) Probably Hamburg; (2) Oslo. 
Psycho: Bremen relaying Hamburg. 
Man of Kent: Cadiz (EAJ3). 
Croydonian: (1) Insufficient detail; (2) Madrid (R. Iberica). 
G.G.D.: Norddeich (weather report, etc.), 1,800 m. 
Y.V. (Horncastle): Possibly Madrid (Radio Iberica). 
A.A.6 (Perth): San Sebastian. 
American Radio and Pip: Probably WBZ. 
Enderby: November 23rd, Hamburg; November 26th, Radio Toulouse. 
Bristol 6: Koenigswusterhausen. 
Curious: Probably Bremen, relaying Hamburg. 
Keystone: Hamburg. 
Totten: Probably a Spanish station. 
E.H.R.: Copenhagen. 
Tammy: Cannot trace. 
Langtonian: Cannot trace. 
Ginger: Radio Toulouse. 
W.H.D.: Berlin. 
Wireless Willie: Barcelona (EAJ1). 
T.C. (Bolton): Cannot trace, but believe from Barcelona (EAJ1). 
Vernianico: Probably Seville (EAJ5). 
Wings Three: Bremen. 
Marshall (Mildenhall): Insufficient data. 
Piquee: No; Leipzig gave own programme. 
Radios: (a) Madrid (EAJ7); (b) San Sebastian. 
Dratit: (22), probably Oslo; (24) Bremen. 
Albion: Petit Parisien. 
Clericus, Medicus, J.L.P., Hook-Up, Aboni: Almost certainly an American station, identity uncertain. 
P.Z.: Oslo. 
J.O.B.: Probably San Sebastian.