brook): Hamburg (weather and news).  
J. F. S. (Tidworth): Dublin, news in English followed by Irish lesson.
Ir (Fleet): Yes, WGY (Schenectady) direct.  
Silvester (Fleet): Yes, WGY (Schenectady) direct.  
RUYM (Ramsgate): 2XAF, which you received on Monday would not be transmitting at 18.10 on Tuesday; this sounds more like amateur.  
Mallon (Walton): Possibly WCCO (Minneapolis), relaying WGY (Schenectady).  
Screened Grid (Leeds): WTAM (Cleveland).  
4 Valve (Green Street): Moscow (Comintern RDW), not mandoline, but balalaika.  
Elliott (Saltash): (1) WIOD (Miami Beach, Fla.) on 247.8 m.; (2) cannot trace; (3) PTT Lyons on 39.50 m.; (4) regret, cannot trace; (5) harmonic.  
A coupon must be sent with each question.  
P.M.G. (Letham): (1) Madrid (EAJ7); (2) WGY (Schenectady) direct.  
Cymro (Chester): WJZ (Boundbrook).  
Valve (Oakengates): Rome, a concert of Italian music.  
Single Valve (Batley): Estimate of WL too vague; regret cannot possibly identify transmitter from one item of dance music.
Gridleak (Kingâ€™s Heath): Item not advertised in programmes, but possibly Hamburg.  
E. G. K. (Walthamstowe): Yes, WGY (Schenectady).  
Enos (Radstock): (1) Barcelona (EAJ1); (2) Cologne direct (3) Hamburg, relaying English lecture from Koenigswusterhausen; (4) PTT Toulouse.
Beelzebub: Cologne (283 m.).  
Whittingham (Purley): Details too vague, regret, cannot trace.  
Anode Resistance (N. 16): (1) a foreign relay of 5XX; such relays, however, are seldom advertised; (2) 60T amateur, Harringay, N.14; 6LL, amateur Clapton, E.5; 2NX  = amateur, cannot trace.
J. E. F. (Portslade): Opera not advertised, but possibly Naples, which was relaying from the Theatre San Carlo at that time.  
Dumbleton (Bristol): (1) Prague, concert relayed from the Narodny Restaurant; (2) Hamburg, dance music by the Francesco Scarpas Melrose Orchestra.  
Xmas (Forest Gate): (1) Frankfurt-on-Main; (2) Berne, relaying orchestral concert from the Kursaal.  
Completely Done (Didcot): Croydon or Lympne aerodrome communicating with aircraft (900 m.).
Dennett (Glasgow): (1) KDKA (East Pittsburg); (4) WBZ WGY (Schenectady).  
Corder (Birmingham): A coupon must be sent with each enquiry; we are holding other enquiries back for further coupons.  
Allen Shaw (Colne): (1) WGY (Schenectady); (2) WEAF (New York).  
Searcher (North Wales): Not advertised in programme, but possibly Vienna (Rosenhuegel).  
Royson (Leicester): We regret but we cannot possibly tell you, as details of dance music are published in programmes.  
5RG: Salamanca.  
Apart from Madrid (EAJ7), possibly Madrid.