Stockholm. Siamese Twin: (a) Nuremberg, (b) Munich.
W. J. Gillett No. 1: W.L. too vague, probably Madrid (EAJ6).
Bull Dog: Hamburg. Tags: Much too vague.
Locarno W. K.: Madrid (EAJ7).
A. R. (Hinckley): Waterloo (Cleethorpes): Hamburg.
Detector: Moscow (RDW). Coil Pusher: Lyon-la-Doua. Two-Valver 1½ kw.
Interested: If German, Vienna gave opera (Siegfried), but Hamburg and Leipzig plays of Spain.
Mac (Derby): San Sebastian. Peace Disturber: Hanover relaying Hamburg.
Simple Three (Litherland): Madrid (EAJ7).
Hereward 7: Frankfort-on-Main.
Hereward 8: Prague.
S. G. W. 2V (Finchley): Relay of Stockholm.
Grimstock: Apparently Stettin relay of Berlin.
Curser (Highbury): W.L. apparently wrong; Hamburg.
A. B. C. (Lanarkshire): Prague.
Moonraker: (1) Item not in programmes, but presumably relay of Stockholm, (2) Berlin.
Voltage (Darwen): Item not in programmes, but presumably relay of Stockholm.
Goo-Goo (Midhurst): San Sebastian.
Straight Three: Hamburg.
E. W. G. (Phyl): Moscow (RDW), 8 strokes on gong for time signal 6 G.M.T.
Ripple (Cambridge): (1) (8.30) cannot trace though W.L. was this by Koenigsusterhausen, not detailed in programme.
Arrell Park (Spool): Presumably Bournemouth.
A. R. P. S. (Newcastle-on-Tyne): Cardiff (Welsh service).
Wavelength Willie: Hilversum.
One Valve S.C.A.: Late transmission, Barcelona (EAJ13).
Cotswold: Presumably amateur, cannot trace.
3HTL: No detailed coupon enclosed.
M. (Kings Lynn): Amateur (Hounslow).
W. J. Gillett: (2) Amateur, cannot trace, (3) amateur, cannot trace.
Check (Bolton): presumably Spanish station, either Bilbao (EAJ9), or Barcelona (EAJ1).
Daimler: Cannot trace.
L. 42914: (17.35) item not given in programme, presumably Malmö, relay of Stockholm, (20.40) cannot trace, was this not Hamburg?
Merci: Sorry, you should be more definite.
Laughing Mask: (7.0) no indication of W.L., dance music and thistle would tally with San Sebastian, (6.10) no W.L. given, cannot trace.
Howells (Llanelly): No W.L. indicated.
H. H. W. S. (Birmingham): Egroeg; Bags: Presumably Rugby testing.
Herr Bewyf: Rugby station testing.
Coegnant: Stettin relaying Berlin.
Wiff: Bournemouth.
Flip (Liverpool): not in programmes, presumably Barcelona.