trace. 

Zwei Valves: Madrid (Union Radio).  
Y.R. Less: Hamburg and Muenster. 
E.L.W.: San Sebastian. 
Falstaff: (7, Buda-Pesth, 7.50) Madrid (Union Radio). 
H.McK.: British amateur. 
H.F. Orchard: Probably Hamburg. 
W.R.P. (Newport): Berne. 
O.G.S.S.: British amateur. 
Bekenfi (Brussels): p.m. or a.m.? 
Family Four (East Ham): Barcelona (Radio Catalana). 
Ack-Ack: Probably WGY Schenectady. 
Elijah (Mortlake): Hilversum. 
Niffy (Deal): Cardiff. 
Blairdevon: Norddeich (1800 m.). 
Novice: W.L. probably wrong, cannot trace. 
Redrock: Frankfurt-on-Main. 
Radio (Malta): Elberfeld. 
K.P.D.: Radio Paris. 
Gilbertian (Bristol): Elberfeld (259 m). 
Londen (Oxford): W.L. wrong, cannot trace. 
C.A.T.: Dresden (296 m). 
Terra: Radio Paris. 
O.H.M.Y.: Hilversum. 
B.S.A.: Berlin (1300 m). 
Clarendon: (1) Hamburg. (2) Berne (Switzerland). 
Beer Toc: Probably Cadiz (EAJ3) midnight transmission. 
Silver Bell: Bremen. 
W.G.P. (Goodmayes): Cannot trace. 
B.S.A.: (2) Cannot trace details too vague. 
Bobby: Stuttgart. 
Burst Valve (Bradford): WGY Schenectady. 
Kit Kat: Cannot trace. 
O.M.A.: B.B.C. station. 
V.P. (Altrincham): San Sebastian. 
Ronnie (Scunthorpe): Presumably not B.B.C. station. 
D.B. (Co. Cork): Radio Iberica (Madrid). 
Hetty: Cannot trace. 
T.H.S. (Alfold): (27/12) vague, probably Hamburg, (23/12) Madrid (Union Radio). 
Wicklow: Yes, Radio Paris. 
Trebuh (Littlehampton): WGY Schenectady. 
I.S.W. (Hanley): Radio Toulouse. 
Curious: Radio Lyon relaying Paris. 
Keystone (Edinburgh): Yes, Radio Lyon relaying Radio Paris. 
Pit-Pat: WGY Schenectady. 
Derf: Malmo, (11 p.m.) San Sebastian. 
A.M.M. (Perth): Relay of Stockholm. 
Captain Arthur: Hilversum (1050 m.). 
Bexhill-on-Sea: WGY Schenectady. 
Loud Speaker: San Sebastian. 
E.H.F.: If French, probably Lyon la Doua, not advertised. 
C.D. (Bristol): Radio Toulouse. 
Menu (Newcastle-on-Tyne): Radio Paris. 
Dual Power: Koenigs wusterhausen. 
Straight Four (Erith): Insufficient detail, cannot trace. 
W.A. (Arbour St): Radio Paris. 
Darkie: Probably U.S.A. station. 
Moston: (1) Berne (Switzerland), (2) Madrid (EAJ7), (3) Hamburg. 
Triumph (Northampton): Hamburg. 
Law Hill (Dundee): Madrid (EAJ7). 
Sapper (Hounslow): Yes, Hamburg. 
Falstaff (Birkenhead): WBZ Springfield, Mass. 
Indoor Aerial (Newton Abbot): Gothen.