Hereward: (1) Oslo.
Rover (Swadlincote): Probably harmonic from Daventry.
Victoria, Aaron, Wilmato (Ilkley), Lutheran (Cornwall): Hamburg.
Scherrie (Blackburg): (a) Norköping, relay of Stockholm; (b) Brussels.
Kitten (Blackburn): Rome.
Arjoro: Probably harmonic of Daventry (Kitcat Band).
L. Burton: Cadiz (EAJ3).
Little Harp: Perhaps landline inductance.
Q.S.L.: Radio Toulouse on 441 and 180 m.
Neutrodyne IV (Dulwich): W.L. apparently wrong, cannot trace.
Optimist, Wireless Watcher (West Hartlepool): Madrid (Union Radio).
T.R. (Ilkeston), Thames Electric, Jenny, Frankie (Dulwich), D/689 (Bristol): Berlin (1300 m.).
BM/BCLB: Probably Elberfeld.
The Wonderer: Eiffel Tower relaying PTT (Paris).
Eboracum (Gt. Yarmouth): Berlin.
Goodchild: Barcelona (EAJ1).
Jacko (Tun. Wells): Persbureau Vas Draz, Amsterdam.
L.S.L.: Radio-Toulouse.
J.E.: Cannot trace, unless Lyons testing on lower W.L.
Interested (c): Buda-Pesth (b) WPG, Atlantic City (299.8 m.); (c) cannot trace call sign.
Two-Valver (Glasgow): Too vague.
Iwannaknow: (1) Bremen, (2) Hanover relay of Hamburg; (3) Seville (EAJ5), (4) San Sebastian.
Loudon (Loughborough): KGO Oakland, Cal. (361.2 m.). Red Top: Cadiz (EAJ3).
Early Riser: Probably Hamburg testing.
Echo: Bremen and Hanover relaying Hamburg.
Star: Zurich.
Hardware: Ryvang (1160 m.).
S.T.3 Dualise: WBZ Springfield, Mass (333.3 m.).
Wynnex: (1) Madrid (Union-Radio), (2) Berlin (1300 m.).
D.C.A.: Probably Hamburg testing.
Archer: (1) Petit Parisien, (2) WGR, Buffalo N.Y. (319 m.), (3) Seville (EAJ5).
H.F. and D.: Radio-Berne.
A.J.L.A.: Madrid (Union-Radio).
Delighted (Leicester): San Sebastian.
Barbers L.D.S.Y.: Probably WGY, Schenectady.
43, B.R.H., N.8., L.: Koenigswusterhausen.
Morse: Hamburg.
Edinburgh 11a: Jonköping or Malmö (Sweden)
Cosmos: Hanover.
Wally: Weringswusterhausen relaying Daventry.
Transformer: Yes, Koenigswusterhausen relaying Daventry.
Rose Villa: San Sebastian.
F.W.B.: Berne.
Accumulator (Oxford): Koenigswusterhausen.
Felix: (1) Madrid (Union-Radio), (2) probably PTT (Paris).
Hambone: Madrid (Union-Radio).
J.B.S.: (a) Moscow’s late concert was not advertised, perhaps Karlsborg (1380 m.), (b) cannot trace.
Topsy: Hamburg.