Jay-Jay (Sunderland): Madrid (EAJ7).  
Our Bill: WL.  
Bimbo: Can trace no other station than Radio Paris.  
3CF/13SP (Wandsworth): Kiel, relaying Hamburg (La Traviata from theatre).  
The Sheik (Lincs.): Berlin (1,300 m.).  
Early Bird (Neath): KDKA (East Pittsburg).  
F. W. C. (Maidenhead): (1) Barcelona (EAJ13), (2) possibly Cadiz (experimental concert), (3) Madrid (EAJ7).  
Felix Foster (Dundee): Berlin (1,300 m.); German National Anthem, "Deutschland ueber Alles."  
Anglo-American Six (Southport): Prague.  
Shaftesbury Three: Berlin.  
4 Valves (Leicester): KDKA (East Pittsburg).  
Will o' the Wisp (Woodford): Rome.  
Brighto (Nottingham): (9.10 p.m.) Oslo, (9.30 p.m.) yes, Muenster.  
E. W. W. (Bath): Relay of WGY (Schenectady) London or Manchester, more probably London.  
Courtbuild: Dortmund, own concert, then relay of Muenster.  
Fishing: Zurich.  
E. W. A. J. (Brussels): Cannot trace, no Swedish relay on 240 m.  
Charleston Podge (Lynsted): Amateur transmission.  
Unbelieved (Liverpool): KDKA (East Pittsburg).  
G. A. K. (Bath): Probably WJZ (pronounced RDW), call "Radio Moskva."  
Night Star (Blackpool): (1) Prague, relayed from Smetana Hall; (2) Nuremberg, relaying Munich; (3) Graz, relaying Vienna (The Last Waltz); (4) Hamburg (La Traviata); (5) Breslau.  
Eraricus 1.: WL too vague, cannot trace.  
Malvern: No, this was Cassel, relaying Berlin.  
F. S. B. (Peterboro'): (a) WGY (Schenectady), (b) apparently WYI (Roundbrook).  
Valve (Seaton): Relay of 6 days' Cycle Race, apparently Hamburg.  
T. P. B. (Gorleston): Berlin.  
Jason: (1) Breslau, (2) Hanover, relaying Hamburg.  
Retta (Syston): Frankfurt-on-Main (ticking of metronome).  
5.W.12 (Liverpool): WL.  
Leobee: (13/11) WL presumably wrong, Norddeich (weather report, 1,800 m.), (14/11) Berlin (1,300 m.).  
Narran: Oslo.  
Terminal (Ewell): Toulouse.  
Rob Roy: Cadiz (experimental concert).  
Marow: Possibly Prague (348 m.) transmission.  
Hereward 1: Frankfurt-on-Main, relaying Berlin.  
Allied Filmite (London): WGY (Schenectady).  
Cantilever (Forest Hall): (1) Lausanne, (2) Hamburg.