3.D.E.2: Prague.
Howie: probably British amateur.
One Fine Day: Marseilles, relay of PTT, Paris.
Lady Be Good: San Sebastian.
Night-Owl: Madrid (EAJ7).
Advert (Canterbury): Kiel, relay of Hamburg.
M.O.V.2 (Southampton): (1) San Sebastian, (2) vague, Radio Toulouse.
F.H. (Plodder): Berlin (1300 m.).
E.M.: Breslau, relay of Berlin.
Interested (Sussex): a test; cannot trace.
Carrots: Hamburg.
G.G. (Hanwell): Hilversum, probably variation in WL. to avoid interference from morse.
Coil Pusher: (1) Norddeich, (2) Sorö, relay of Copenhagen (Opera House).
I. H. C. S. (Leonards): amateur.
Beaufort (Swansea): no estimated W.L. given.
Heidi: Frankfort-on-Main, relay of Berlin.
The Prince Receiver (Gatford): Madrid (EAJ7).
Memo: cannot trace on that W.L.
Barcelona (Spain): 3336 (Southampton): (1) too vague; not an ordinary transmission; presumably a test; (2) Malmö, relay of Stockholm; (3) Hanover, relay of Hamburg.
Jugo (Lowestoft): cannot trace; presumably amateur transmission.
Gecophone: (1) Kiel, relay of Hamburg, (2) Bremen, relay of Hamburg.
Sailor: Sorö, relay of Copenhagen.
Smith (Acocks Green, B'ham): If WL. correct, Madrid (EAJ7), but item not in programme; believe this was Hamburg.
Ray (Surrey): (a) detailed items point to Milan, (b) can trace no broadcast transmission in programmes, was this not Haeren (Belgium) weather forecast on Flemish on 1100 m.
Wenli: Montpellier, relay of Radio Toulouse.
Chene, Little One, F. L. B. C., Finglas, Wealden (Kent), Wickholm: Hilversum.
N.H.J.T.S., Wave Trap (Chadwell Heath), Gwynne (Devon), Night Hawk (Portsmouth), S.T.10 (Mile End), Marine Engineer (Poplar), Brownie (Westoken), W. S. H. (Cambridge): Berne.
Cossorite (Port Talbot), Bonus (Jersey), Radio (Coventry), X T. 4813 (Tottenham), Hopeful (Cricklewood): Berne (see foot note).
Offaly: Madrid (EAJ7).
Vulcan: (a) Yes, Stettin, relay of Berlin, (b) Frankfort-on-Main, relay of Berlin.
T. A.3 (Plumstead): Madrid (EAJ7).
Four Valvo (Dublin): Hamburg.
L.K.B.: Madrid (EAJ7).
Konk (Norwich): Berlin (1300 m.).
Mercury: Cannot trace transmission on 150 metres.
Ajax, Als (Coventry): Madrid (EAJ7).
Town Mill: Your W.L. Ao W. (350-400 m. comprises 22 European stations), C.O.M. (Barnet): Madrid (EAJ7).