shire): London was broadcasting "The Roosters" from 9.25 p.m., and 5XX took part of this programme from between 10-10.30 p.m. Probably a Continental relay of 2LO. 
Seal (Liverpool): Madrid (EAJ7) from Ice Palace.
Polkynth Two (St. Austell): Radio-Catalana (Barcelona EAJ13).
Cayenne (Bradford): Surely Langenberg relaying from Kaiserhof, Muenster.
Marconiphone 4 (Edinburgh): (1) Wl. wrong, Zurich, (2) Yes, Riga, (3) Bruenn relaying Prague.
Marconi Sund 4 (Sunderland): (a) Stuttgart relayed by Innsbruck, (b) Juan-les-Pins (France), (c) rather vague; possibly Gleiwitz, (d) Muenster relaying Langenberg, (e) Kiel relay of Hamburg taking Turandot from Dresden.
Shanklin: Koenigsberg, Carnival evening; confirmed. Naples is received well in British Isles. Most of the German stations are of 4 kw. power.
Windy (Jarrow): You give no details of transmission; at that hour, Hamburg or one of its relays.
Dorothy (Salisbury): No coupon enclosed.
The Goods (Petersfield): (1) Copenhagen, (2) Barcelona (EAJ1) on 344.8 m, (3) Yes, Bilbao (EAJ11).
H. W. F. (Eltham): (1) Are not these dates reversed? Dortmund; (2) WL., apparently wrong; cannot trace.
F. S. (Gatesham): Koenigsusterhausen relay of Frankfort-on-Main variety programme.
Napier (Bush Hill Park): WL. too vague to identify transmitter; you almost covered the whole broadcast band.
J. C. U. H.: Hamburg (first news bulletin and gramophone records).
Old Bill (Clapham): Dublin.
Schoolboy (Kilry?): Yes, WBZ (Springfield, U.S.A.).
S. Skelton (Hendon): WBZ (Springfield).
Geoff (York): No, Breslau which uses a metronome.
Edison Four (Shepherd's Bush): Quite possibly a relay by Copenhagen.
Duo-Xyac (Coventry): Madrid (EAJ7).
Family Four (Mile End): WGY, Schenectady.
Searcher (Rusholme): (22) Yes, Rome relaying from a variety theatre, (23) Possibly Oslo.
Daddy (Gainsboro'): (1) Barcelona (EAJ1), (2) Graz (own prog.).
Derf (Mosley): Budapest (relayed foreign transmissions).
Pogo (St. Albans): First news bulletin from Hamburg (through a relay station); WL. too vague to identify.
G. E. M. H. (Finchley): Vienna (play).
Warner (Romford): Koenigsusterhausen relaying Frankfort variety programme.
Coastal Three: Lyons PTT relaying Paris.
Crossword (Ramsbottom): (15) Hamburg first news bulletin, (16) Hanover (see 15), (17) We know of no French station on that WL.; possibly Geneva, which later relayed Berne, (18) Could only be Langenberg; it was advertised to close down at 9.30 p.m. (G.M.T.).
G. R. 15 (Arthurstone): Either Oslo or Porsgrund.
Cotton (Stockport): Frederikstad relaying Oslo.