Optimist: presumably Barcelona (EAJ13).

Searcher: (a) Malmö, (b) Hanover.

Three Valver: no date given.

Jerry: (1) Leipzig, (2) Berne.

4VS4: no W.L. given.

MAZZ: B.B.C. experimental station.

Three Valve (Eve): W.L. wrong, probably Berne.

Gay Blondel: Nuremberg.

Achtung: Koenigswusterhausen.

Revelly: Radio Berne (Switzerland).

Ern (Harrogate): probably Moscow.

Duo: Berne.

Excel: no French station on that W.L., may have been Swedish relay.

Dulwich: Keston testing relay of KDKA.

Dugie (Port Talbot): Berlin (Opera Oberon).

E. A. (Perth): Koenigswusterhausen (Press news).

Accuracy: Berne test transmission on 315 m.

Railway (Great Yarmouth): Hamburg.

Bayite: Hamburg.

Distance: 4 a.m. or p.m.?

Machirk: probably Barcelona (EAJ13).

T.H.T. Weston: Berlin.

Normad: cannot trace.

Smoke Flake: (1) Hamburg, (2) B.B.C. station testing.

Earth: Madrid (Union Radio).

Schoolboy (Kettering): Hanover.

Whiskers: cannot trace.

D. M. L. (Derbyshire): San Sebastian.

Low Loss: (a) Nuremberg, (b) Brussels.

Searcher: probably Hilversum.

Ubique: Hamburg.

Renrut: probably Dortmund.

Gower: San Sebastian.

T. H. S. (Alfold): (7.55) San Sebastian, (8.0 p.m.) rather vague detail, but probably Frankfurt.

Harmony Four: Berne.

Anode Reaction: (A) Malmö, (2) Elberfeld.

Watchman: B.B.C. (Keston) testing relay.

Night Hawk (Liverpool): Bilbao (EAJ11) 418 m.

Harkaway (Guernsey): if French, presumably Petit Parisien, but no concert advertised.

G. D. (Bristol): Bremen.

Crossley: Koenigswusterhausen.

Live Wire, Tenk: Hamburg.

Amon, Ediswan (Strood): Radio Iberica (Madrid).

H. L. (Kensington): Koenigswusterhausen (Press news).

Kittentor (Blackburn): Union Radio (Madrid).

The Fiddler: cannot trace, probably British.

Raw: Cadiz (EAJ3?).

M.V.2 (Muenster): Dunedin.

Unless Rome, cannot trace.

S.W. (Scartho): Berne.

Tropadyne: Malmö.

H. C. (Ramsgate): San Sebastian.

One Valver (Bath): Union Radio, Madrid (EAJ6).

Lorendon: (1st to 4th) San Sebastian, (12th) Stuttgart (446 m.).

Day, DBY: Lyon PTT relaying Paris.

MacCroy: Keston testing relay.

3 Valves (Leeds): San Sebastian.

Ilkley: cannot trace.

Wireless Villain: Union Radio (Madrid).

4A17: presumably Barcelona EAJ13.