RDW: D.X 4: Madrid (EAJ6).
New Aerial G.S.F.: Madrid (EAJ7).
Gecophone: Zurich.
Clapton: Madrid (EAJ7).
Frascati: Breslau, relay of 6 days’ cycle race.
Reglastan (Deal): Berne.
Ediswan (Manchester): Madrid (EAJ6).
T. C. (Bexhill-on-Sea): Moscow (RDW).
H. A. Hyde: Probably Bilbao (EAJ9).
Hypo (Penge): Hamburg ex Hanover.
Avion: Berlin (576 m.).
Knighton Fields (Leicester): Cannot trace.
Shal Wave: (a), (b), (c) Cannot say, KDKA, WGY, and WJZ work on various short WL.s.
Rotarytune: Prague.
N. F. A. (Waterloo): Presumably WGY (Schenectady).
A. J. S. 4: Malmö.
Morty (Leigh-on-Sea): WJZ (Boundbrook).
Trio V. Twie: Madrid (EAJ7).
G. A. W. (Notts): Bilbao (EAJ9).
Jilwilton: Hamburg.
Fishing: If German, Dresden, but believe Gothenberg.
Cowboy: (15/2) Very vague, Berlin, (13/2) too vague.
Harmony Four: Koenigswusterhausen.
Malvolion: Koenigswusterhausen (lectures).
H. C. M. (Ramsgate): Malmö.
H. B. (Earl Shilton): WL. too vague.
Carolus (Stonehaven): Hamburg or Berlin.
Live Wire (Glasgow): Hanover.
C. J. T. (Carhampton): Seville (EAJ5).
Guy: Presumably Helsingfors, but no programmes available.
Trois Lampes: Berne.
R. J. W. (Norwich): Hamburg.
Wuncell IV.: Cannot trace, but surely six pips from B.B.C. Station.
Felcov: Hamburg.
Tea-Pot (Firsby): Breslau.
Plug: Madrid (EAJ7).
White City: Karl Zander, Berlin actor at Breslau.
Forest Hall: Moscow (RDW).
2 V.H.V.: (1) Amateur (Liverpool), (2) Bilbao (EAJ11).
A. C. (Harborne): Hamburg.
Valve (Eversham): (6 p.m.) Hamburg (English lesson 1.30) Yes, Radio-Paris.
Pongo: Cannot trace.
W. E. B.: Madrid (EAJ7), see panel.
R. G. R. (Beds): Radio-Paris.
Redral: Presumably relay of PTT by Eiffel Tower, WL. apparently wrong.
Novice: Would tally with Odense, but not in programme.
Interested C. H.: Karlsborg.
Wendy (Liverpool): San Sebastian.
Strad Bivalve: If WL. correct, Kiel.
Holmrook: 2RC amateur (Birmingham).
2 J K: amateur (Richmond).
Neutrodyne (Windsor): Cadiz (EAJ3).
Tinker (Crewe): Hamburg.
Ticker (Cheltenham): (6.25) Cannot trace item in programmes, (11.15) Bilbao (EAJ11).
Manchester: (a) Item very vague, (b) item too vague.
Devonian: Prague.
Racehorse: Koenigswusterhausen (lecture).
Radio Bug: (1) Probably Toulouse, item could not in programme, (2) Breslau.
W. A. S.: