Aberdonian: (1) Kalundborg, relaying Tea Concert from Copenhagen, (2) your estimate of W.L. is too vague, regret, cannot trace. A coupon must be sent with each enquiry.  
Tommy Pratkins (Eastbourne): Frankfurt-on-Main. (Early morning physical exercises).  
Eva Brick (Southport): (1) Madrid (EAJ7), (2) you do not say if this was in the English language; if so, apparently an amateur transmission.  
Zittrer: Nürnberg, relaying Munich. Guitar concert, followed by marches by Blankenburg and news and weather.  
A Night Home (Eastbourne): Apparently a German station, but it is impossible to identify as you give no estimate of wavelength.  
Cormorant (Morecambe): Huizen (Holland), 1,840 m. Church service followed by lunch-time music.  
Scrounger (Hove): (1) Koenigs Wusterhausen, relaying Berlin. Talk before dance-music, (2) Stamboul (Turkey), about 1,180 m.  
Tea Pot (Firsby): Frankfurt-on-Main. A request programme of gramophone records.  
Anthem (Oldham): Frankfurt-on-Main, relaying dance-music from Cassel. The German National Anthem is played to the melody of the old Austrian Hymn, the music of which is by Haydn.  
H. B. P. (Torquay): Huizen (Holland) testing. Gramophone records, possibly of the same service Tattoo.  
Glysal (Seething-on-Thames): Apparently an amateur transmission, but cannot-trace as you give no call sign.  
Plumbob (Leeds): (1) Yes, Oslo. Dance music until midnight. Address: Kringkastingsselskapet A/S, Stortingsgaten 24, Oslo.  
F. Merchant (Tidworth): Kalundborg, relaying dance music from the Restaurant Nimb at Copenhagen. Chimes from the Town Hall at midnight (11 p.m. G.M.T.).  
Oscillating (Birmingham): Motala, relaying the Changing of the Guard at the Royal Palace, Stockholm.  
Papyrus (Leigh-on-Sea): (1) Your details are too vague, regret, cannot trace, (2) yes, Breslau, a concert of gramophone records; (3) cannot trace these items at that time from any Continental station.  
Tida Dawei (Forfarshire): This was the 2LO relay of 2FC (Sydney).  
Ether Cog (Sheffield): Huizen (Holland) testing on 1,840 m. Gramophone records.  
Wireless Walter (Cranleigh): Yes, possibly KDKA (East Pittsburgh), 62.5 m., but cannot confirm as no detailed programmes are available.  
R. B. F. (Edinburgh): (1) Stuttgart (Talk). See programme in World-Radio, (2) if W.L. correct, Prague.  
Llandaff City: We regret that we cannot trace, but it is impossible to identify station heard, without some estimation of W.L. and condenser readings do not help.  
S. T. 100 (Birmingham): Kalundborg, relaying dance music from the Restaurant Nimb at Copenhagen. Chimes from the Town Hall at midnight (11 p.m. G.M.T.).  
Rags (West Lothian): Munich. On 30/10/27, relaying orchestral concert from the Cafe Stadt Wien.  
Lymp 4 (Exeter): 5CK, am&teur (Nottingham).  
1 Valve (Seaton): (1) Your details would only tally with Vienna, which was broadcasting a musical comedy at that time (“Der Liebe Augustin’’); (2) Yes, Breslau.  
G. Cooke (Blackpool): Warsaw (vocal and instrumental concert).  
Very Mystified (Didcot): W.L. apparently wrong, possibly Warsaw.  
Scrounger (Hove): (1) Koenigs wusterhausen, relaying Berlin. Talk before dance music, (2) Stamboul (Turkey), about 1,180 m.  
Grid Leak (Leicester): Moscow Comintern (RDW). Special bulletins broadcast for the benefit of men’s clubs and rest houses ; they are read slowly in order to allow transcription to be made of the news.  
Beina Calafia: No, this was Breslau. The German National Anthem is played to the melody of the old Austrian Hymn of which the music is by Haydn.  
Queen Fisher: Basle, relaying Berne.  
Glebo (Wallasey): Apparently Frankfurt-on-Main, relay of the third Friday Concert. “Singer” is Elizabeth Schumann. Details of programme were not advertised.  
Grip (Merthyr): It is impossible to identify station heard without some estimate of W.L. There appears little doubt that this was an Italian amateur.  
Neutrodyne (Dorking): Yes, 2XAF, short-wave transmitter of WGY (Schenectady). The General Electric Company often experiment in relays of the British transmissions, and it is quite possible on this occasion it was taking Daventry, but cannot confirm.  
Short Wave (Lincs): details much too vague, regret cannot trace. Kalundborg, relaying German lesson from Copenhagen. Chimes taken from the Town Hall at 12 noon (11 a.m. G.M.T.).  
Water Pipe (Edinburgh): Leningrad.  
J. Gibson (Glasgow): Apparently a test, but details too vague, regret cannot trace.  
2 Valver (New Southgate): (1) Nurnberg, relaying guitar concert from Munich, (2) Barcelona (EAJ1), relaying Madrid (EAJ7). Selection from a musical play.  
G. E. C. (West Derby): Moscow Comintern (RDW).  
Jam (Bristol): (1) Muenster, relaying Dortmund. Organ recital relayed from the St. Reinoldi Church, followed by a relay of a talk from Cologne via Langenberg, (2) Your details are too vague, regret cannot trace, Schoolboy. No, not Graz, this was Falun, a relay of Stockholm on 356.1 m.  
Big Ben (S.W.10): (1) Radio LL, Paris. (2) Milan (a lady announcer). Time signal, followed by relay of operetta. (3) Nürnberg; relaying Munich. News, followed by Cabaret.  
Panton (Grimsby): Apparently the new station at Cattowitz (Poland) testing on 422 m.  
Rustic (Coatbridge): Do not understand your W.L. This was a B.B.C. relay of the 2FC (Sydney) broadcast, taken by 5GB, 5XX, 2LO, Plymouth, Stoke-on-Trent, Newcastle, Manchester, Sheffield and Leeds, and also by Swansea and Cardiff at 6.15 p.m.  
H.F. 42 (Regent’s Park): Rather vague, but would tally with Barcelona (EAJ1), which was relaying Madrid (EAJ7). A selection from a musical play.  
B. L. (Glasgow): We regret that we cannot trace, as it is impossible to estimate W.L. from your condenser readings, unless given to two outlets you have identified on either side of the unknown transmitter.  
Scrounger (Hove): Petit Parisien was not advertised to work until 9 p.m. on that evening. We can trace no station on about your estimate of W.L. giving an organ recital at that time. Possibly a test by Petit Paris en.  
Wessex (Paignton): Dortmund, relaying organ recital from the St. Reinoldi Church in that city.  
Novice (Carlisle): Yes, Moscow Comintern (RDW), but cannot say what, this broadcast was, as no detailed programmes are available.  
Lidher (Plumstead): Koenigsberg (variety concert).  
Sharland 2 W (W.12): Yes, Milan, relay of operette, followed by News and relay of dance music from the Fiaschetteria Toscana.  
Wafty (Witney): Kalundborg, relaying dance music from Copenhagen.  
G.M.L. (Bristol): Chimes from the Town Hall at midnight (11 p.m.).  
Gotham (Bristol): Amateur transmission (gramophone records).  
Dumpty: Hilversum. This station gave dance news until 11.40 p.m. on that evening.  
Qu’est-ce que (Fulham):  
Queen (Bishop Auckland): Fisher (Grantham): Kalundborg, relaying Copenhagen (altered programme).  
N. J. N. (Oldham): Naples, relaying from theatre.  
Econ (Leeds): An amateur transmission, but cannot trace as you.```
S. (Harrow): Basle, relaying Berne.
J. G. (Derry): Rather vague, but possibly San Sebastian (EAJ8).
Curious (York): We believe this to be Almeria (Spain) on about 315-319 m.
Four Valver (Bristol): An amateur transmission, but cannot trace as you give no call sign; (2) wireless telegraphy station, not a broadcaster.
Carocross (Solihull): Madrid (EAJ7), altered programme.
Anything (E. 11): Apparently gramophone records, but we cannot trace any Continental station working at that time on or about 450 m.
Cornish Five: If your estimate of WL is correct, Bergen, but this station was not advertised to close down at so late an hour.
Derf (Morley): It is almost impossible to trace from condenser settings, but from details of items given, A and B would tally with Kovno (talks) and Leningrad (surely not a preacher!), C and D cannot trace.
Lass: Moscow Comintern (RDW).
Dioptric (Southwark): Amateur transmission, 2NM Caterham (Surrey) 23 and 33 m.
Derek (Guildford): Huizen (Holland) 1,950 m., Church service. At 2 p.m., Children’s Hour.
G.M.P.3.: Cannot trace tests, possibly your local station.
Five Valver (Cornwall): This was Langenberg.
Bowler (Waterloo): Are you sure this was not Kalundborg, relaying Copenhagen? Your details would tally with the programme published for the latter station.
T. T. Fitch (W. 9): Yes, possibly a relay by French station, but cannot trace. We know of no American station with
```H.J.C. (Birmingham): We believe this to be Almeria (Spain) on about 315 to 319 m.
EA (Wells): (1) We believe this to be Almeria (Spain) on about 315 to 319 m.; (2) Barcelona (EAJ13); (3) Huizen (Holland) 1,840 m.
Radio Roma (Cheshire): (1) We believe this to be Almeria (Spain) on about 315 to 319 m.
Amateur 3: (1) Frankfurt-on-Main, relaying dance music from Cassel, the latter station has a lady announcer; (2) see next reply.
A Small (Matley): Regret, cannot trace.