if dance music, Kiel.  
L.C.M.: details too indefinite, cannot trace.  
Red Dot: Madrid (EAJ7).  
Llanelli: apparently San Sebastian (below 2LO).  
Q6 Major (Mon.): Madrid (EAJ4).  
Tiger Tim: Hamburg, Duplet Tube: presumably amateur.  
Ravelly: W.L., apparently wrong, cannot trace.  
Ebor: Yes, Radio Paris.  
Doncaster: Berne.  
Radsup: cannot trace.  
F.C.H. (Enfield) (27/12) Stockholm; (22/11) Malmö.  
Pape: presumably Moscow (Radio Peredacha).  
J.O.T. (Henteage): no German station on this W.L.  
Battery Bill: Madrid (Union Radio).  
Oxo: S. G. Mason; Bonzo Jones; H. T. Wallis; C. Revill; Rego; Cowpex; Achtung; Norman Conquest; A.L.G.C. Reinartz; Venice Wafer: Prague (368 m.).  
Glencoyne: (a) San Sebastian, (b) Prague (368 m.)  
1 Valver (Liverpool): Madrid (EAJ4).  
Unidyne (Gateshead): Vienna.  
Aerlin: Norddeich.  
Lightning: 5XX relayed by Boundbrook, WGY, Schenectady.  
Geophone: Berlin.  
Jason: Yes, Buda-Pesth.  
Bilbao: (a) Radio Castilla (Madrid EAJ4); (b) Madrid (Union Radio).  
F.E.W.: Berlin.  
Two Valver (Leicester): (1) San Sebastian, (2) WGY, Schenectady.  
Ay Ah Auch: Moscow (RDW).  
Hetty: cannot trace, on that W.L.  
Nomad: probably Belgian amateur.  
Fire Side: Berlin, relay of Daventry.  
Leff (Birmingham): Rome and Hamburg.  
Echo: Oslo.  
L. Ether: Berne (Switzerland).  
Harris (Densbury): Radio Paris.  
H. McK.: British amateur.  
Max of Oftchurch: (a) Berne, (b) too vague, (c) too vague, (d) Madrid (Radio Iberica), (e) WGY, Schenectady.  
Fox-Terrier (Oxford): Spanish station, but W.L. too indefinite.  
Barney: Stettin.  
Ediswan: probably Oslo (request programme).  
Quirotic: probably amateur station.  
Nil Desperandum: Madrid (EAJ6).  
Red 'Ot: (1) Bremen, (2) Hanover.  
Ellen (Brussels): Hamburg (392 m.).  
Jazz: Bremen.  
Guido: Madrid (EAJ7).  
J.T.H. (Hull): cannot trace, probably U.S.A. station.  
Resistoflex: Cadiz (EAJ3).  
Cossack (Oxford): Madrid (Union Radio).  
Edward (Cirencester): Hamburg.  
Seaside: Cadiz (EAJ3).  
J.J.Y. (Ashford): Moscow (RDW).  
Three-Valve: It was Hanover.  
Bilshy: Hanover.  
Zwei Valves: Berlin.  
Bingleyite: cannot trace.  
R.K.F. (Rustington): not advertised, probably Madrid (EAJ6).  
Derf: (270 m.) Malmö; (390 m.) Hamburg.  
High-Wave: Berlin.  
Kangaroo (Norwich): Surely again