Vox: San Sebastian.
G.H.B.D.: Amsterdam.
F.E.W.: Hamburg.
JBTH: Berne.
G.W.Q.: Toulouse.
Ben Wyvis: Madrid, Union Radio.
Songods: probably British amateur.
Tameside: Madrid (EAJ6).
Rem (Birmingham): Madrid (EAJ7).
Habbeshaw: Madrid (Union Radio).
Katja: if a.m., Koenigswusterhausen.
E.A.A.2: too vague.
Instrumental Accompaniment (Nottingham): W.L. too vague, probably Madrid (EAJ7).
Guernsey: Hanover.
Rex (Timperley): Hamburg.
Felix (Killingworth): San Sebastian.
Tim: Madrid (Union Radio).
P. Newns (Chester): Hamburg.
Semper Vigilans: Hanover (296 m.).
Spade: British amateur.
J.S.W. (Manchester): Berlin (210 m.), Stettin.
W.H.D. 3V: probably harmonic of Daventry.
Juvenile: Munich. 
H.E.W.: Oslo.
Special Five: W.L. apparently wrong, no French station operating.
Beechburn: Stuttgart (443 m.).
Sound and Clean: probably Toulouse.
Rome did not advertise dance music.
A.T.G. (Leeds): Barcelona (EAJ1).
Kemi: Malmo.
Flute: Muenster.
Idonia: Karlstadt relay of Stockholm.
E.A.T.A.: Barcelona (EAJ13).
B.E.M. (Dundee): Toulouse (441 m.).
Cabinet 5 Valver (Catford): 
W.W.W.; C.H.B.; Albert Boyes; Frank (Leicester); 
S.T.100 (Plymouth); L.V. (Liverpool) (368 m.).
Jacko: Prague.
Musician: San Sebastian.
Ove head Valve: Hanover (296 m.).
Juno: details vague, perhaps Toulouse.
Hollybush: Hamburg.
Firefly: (1) cannot trace; (2) Breslau.
High Tension: German station, but so late a transmission not advertised.
Primax Loudspeaker: (2) San Sebastian.
Elsie: Yes, either WGY, or WJZ (455 m.).
Priton-Terry N.D.P.: too indefinite.
G.W.R.: Yes, probably Madrid (EAJ6), as they do not keep to their advertised times.
Siki: Untraceable.
D.X.: WJZ (455 m.).
Radio Frequency Choke (Choppington): probably new Strasnice station testing.
Condenser (Norfolk): (10-11) presumably Seville (EAJ5), but cannot confirm (11.15) Madrid (EAJ4) (12 a.m., Madrid (EAJ6).
X.Y.Z.: cannot trace, probably U.S.A station.
18 Gauge: Rome.
Twice One: (1) Berne; (2) Hamburg; (3) San Sebastian.
Watford: E.W.A. if dance music; Kiel.
C. M. G. H.: details too indefinite, cannot trace.
Red Dot: Madrid (EAJ7).
Llamblieth: A.