Mac: Leipzig.
M.F.H. (Hoddesdon): Rome.
Ethereal (Plaistow): Leipzig.
San (Castle Douglas): Madrid (EAJ7).
Mistley: (1) Madrid (EAJ6).
Grocer (Norwich): Hamburg (Café Continental).
A. Smith (Acocks Green): Oslo.
Tuesday: Sorø, relay of Copenhagen.
Beginner (Glyn Neath): Frankfurt-on-Main.
Royalist: Hamburg.
Reflex (Barrow-in-Furness): Barcelona (EAJ1).
The Searcher (Staffs): W.L. too vague, cannot trace.
A. E. C. (Ickenham): Hamburg, relay of Hanover (Café Continental).
Vulcan: Cannot trace; possibly Rugby testing.
Tony (Bootle): Hanover relaying Café Continental.
Novice (Sutton Coldfield): Prague.
Scala (Leeds): Yes, Rome.
Shack (Liverpool): Madrid (EAJ7).
Wallis (Wokingham): Yes, Eiffel Tower not Tour Eiffel (pronounced Ay-fel); 39 Volts (1): Frankfort-on-Main; (2) Cassel relaying Frankfort.
Vidler (Dulwich): Barcelona (EAJ1).
Telegraph (Shrewsbury): Berlin (1,300 m., Call was Achtung! Achtung!).
Shulio: Would tally with Frankfort-on-Main.
B. P. (Bristol): San Sebastian, (EAJ8) Spain.
Moggy (Wolverhampton): Cadiz (EAJ3).
Jopie (Nottingham): probably Cadiz (EAJ3).
3VACDL: Madrid (EAJ7).
Skipper (Lowestoft): Not in progs., cannot trace.
Seeker (Heckington): At this time could only be British amateur or possibly WGY, Schenectady.
H. W. C. (Bristol): Madrid, (EAJ7, Spain).
H. Watch: Leipzig (Call heard: Achtung, Hier Mirag).
Lyn (Swindon): Stuttgart.
W. S. (Fuham): (1) Cannot trace any probable station near this W.L.; (2) Petit Parisien, Paris; (3) Milan; (4) No German relay on those W.L.; details too vague.
Archer: (1) probably PCFF, Amsterdam (Stock Exchange news, etc.); (2) Koenigswusterhausen (Press); (3) Too vague; (4) Yes, Radio L.L., Paris; (5) Radio Toulouse.
Marco: (1) Not in progs.; either Barcelona (EAJ1) or Milan; (2) Breslau; (3) Dance music not advertised for that evening - probably Rome.
Warnarch (Leicester): (3) Prague; (4) Hamburg.
G. G. B. (Great Ayton): (1) Koenigswusterhausen (Press); (2) Cannot trace any gramophone record; (3) ditto; (4) probably aircraft station; (5) Karlsborg (1,365 m.); (6) Ryvang (weather forecast); (7) Hamburg.
Daventry Calling (Southampton): (1) Cannot trace; (2) Milan.