Nugget (Redditch): Hamburg.  
Boy-Scout (Bristol): San Sebastian.  
K.R.V. (Guildford): presumably Hamburg.  
R.G.H.L.: Moscow.  
Reflex: (Carnival transmission). (1) Madrid (Radio Iberica), (2) Koenigswusterhausen, (3) Hamburg, (4) Stockholm.  
Knighton Fields (Leicester): W.L. apparently wrong, too late for Milan.  
Diamond: amateurs, cannot trace locality.  
Croxtonian (Southport): (1) Nuremberg, (2) Madrid (Union Radio).  
Speedy S.W.: Madrid (EAJ7).  
Carlo: Madrid (EAJ6). Via: Yes, Berne (435 m.); Rome same power as old 2LO. 100,000 K.W.  
Duodyne V. (Macclesfield): E.H.F.; Yes, Berne (435 m.).  
Wacode; Notrub; G.R.J.H.: Moscow (RDW).  
Ampere (Redditch); Toby: Berlin.  
Family 4 (Lincs.): (1) Moscow, (2) amateur, cannot trace call sign.  
F.C.B. (London): San Sebastian.  
Broun-Morison: Madrid (EAJ6).  
H.S.: Madrid (EAJ6).  
Pogo: Berlin (recitations).  
W.S.H. (Cambridge): yes, their W.L. is not stable.  
M.I.; Yes, details too vague.  
Tiger Tim: (1) probably Cardiff, (2) Madrid (EAJ6).  
Filbert (Leicester): probably Cardiff.  
Westbourne (Hull): San Sebastian.  
Aerial (Bournemouth): W.L. correct, really Stockholm.  
R.C.T. 4: Seville (EAJ5).  
Crix: W.L. too vague.  
Crysto-Valve: Prague.  
Dull Emitter (Leicester): Yes, Hilversum.  
Tropodyne 6: Stettin.  
Prestwick No. 1: apparently Bergen testing.  
Edmontonian: Hamburg.  
H.J.K. (Farnham): no foreign stations between EAJ7 and Oslo unless Moscow (375 m.).  
Radiocraft: Madrid (EAJ7).  
Cosmos: Karlsborg.  
Howling Blosss (Leigh-on-Sea): Hilversum.  
S.R.: Koenigswusterhausen.  
J.C.P.: Muenster.  
Stanhay: Hanover (Cabaret).  
Target: PTT, Paris.  
E.M.K. (Harrow): Moscow (375 m.).  
Megohm (Tunbridge Wells): Hanover (English lesson).  
O.M.O.: Cardiff.  
Hereward 5: Berlin (News).  
Hereward 6: Berlin (News).  
54 W.S.S.: presumably induction from telephone line.  
Cathcart: (5/2) Madrid (EAJ7), (7/2) rather vague, if W.L. correct Prague.  
Three-Valver: too vague.  
Knighton Fields (Leicester): probably Lyngby (weather report).  
V.3 (Foleshill): Elberfeld.  
Molly Wade: no French station on that W.L., probably Madrid (EAJ7).  
Benny (Hull): (11.30 a.m.) Choir Koenigswusterhausen, (7 p.m.) Hilversum.  
Anglo-American Six (Bournemouth): Madrid (EAJ6).  
Susan: cannot trace.  
Binkie: (1) Prague, (2) Madrid (EAJ7), (3) Bilbao (EAJ9), (4) both relay Muenster.  
Ace: no W.L. given, but tallies with Hamburg.  
Speedy (Ilford): many Continental stations relay 5XX at odd times.  
R. A. L. (Wealdstone): amateur (gramophone record).  
Ulster: (6.30) Dortmund, (6.15) Dresden.  
Nosey (Bristol): San Sebastian.  
H. J. L. (Hounslow): (27.1) Madrid (EAJ7), (31.1) Madrid (EAJ6).  
Robin Hood (Notts): apparently late transmission, Berlin.  
J. W. J.: Madrid (EAJ7).  
Flip: San Sebastian.  
Valvrac (Cambridge): Barcelona (EAJ1).  
Darkie: Toulouse.  
Interested (Acton): W.L. not indicated, probably amateur.  
Andrew (W.5): (1) too vague, (2) San Sebastian.  
Sapper (Hounslow): relay of Emanuel Church, Stockholm.  
Blink: cannot trace on that W.L.  
Wavemeter: impossible to say which station was testing.  
P. D. Q.: (a) presumably Madrid (EAJ7) testing on different W.L., (b) only talk on music advertised at that time, Stuttgart.  
S. W. (Colchester): (a) at that time only talk on music, Stuttgart, (b) probably Elberfeld relaying Cologne.  
Oscillator (Felixstowe): probably Cassel.  
Dull Emitter: Madrid (EAJ6).  
Y. R. Less: (1) cannot trace, amateur, (2) Breslau (418 m.), (3) Bilbao (EAJ9).  
Family Two A.1: Bilbao (EAJ11).  
Popanwob: (7.15) Newcastle-on-Tyne, (7.55) W.L. too vague.  
Bigg: Madrid (EAJ6).  
Yewlagge: Madrid (EAJ7).  
Cymru: Moscow (RDW).  
Pye: Copenhagen, relaying 5XX.  
C. H. P. (East Ham): relay of Stockholm.  
Mutt: probably Moscow.  
Knotbwister; Winkle: cannot say, testing with Rugby.  
H. L. 2: cannot trace, time tallies with Muenster.  
Coil Pusher: (1) sounds like WGY, Schenectady, (2) cannot trace, no French station on that W.L.  
Yarr (Halifax): Toulouse off its W.L.  
X. Y. Z.: (1) Radio Paris, (2) Madrid (EAJ7).  
L. R. D.: Muenster, relay of Cologne.  
Echo (Doncaster): if German, presumably Cassel, relay of Berlin.  
L. W.: apparently harmonic of Koenigswusterhausen.  
A. R. C. (Cottenham): not advertised in programmes, but probably Hamburg.  
Carbamide: Swedish relay of 5XX.  
Leger (Doncaster): Bilbao (EAJ9).  
Amor Ra: cannot say, either Madrid, Bilbao, or Hamburg, late transmission.  
Guernsey: Milan.  
X. Y. Z. (Winslow): not Oslo, cannot trace item.  
Abbottsferry: Toulouse testing on another W.L.  
E. A. S. (Twickenham): Berlin.  
Dale (Hathersage): Muenster.  
E.C.C.: (1) Berne, (2) cannot trace item, but not Oslo.  
H. L. S. B. Y.: (1) Hamburg, (2) Radio Toulouse.  
D. X. 2: Lyon la Doua.  
Toc Pip Esses: Hamburg, heterodyne whistle.  
Old Parish: Rome.  
Chwilywr: Berne (Switzerland).  
(Birmingham): Cadiz (EAJ3).  
G. S. (Tottenham): Cadiz (EAJ3).  
Yarn (Halifax): probably Bilbao.  
All Concert (Aberdare): Madrid (EAJ7).  
Night Owl: Madrid (EAJ6).  
Short-Wave H. B.: probably WJZ (Boundbrook).  
Coil Pusher: (1) Madrid (EAJ6).  
S.W. 2 V.: WJZ (Boundbrook).  
Het: cannot trace, sounds like B.B.C. station.  
Straight Four: Madrid (EAJ7).  
Fishing: too vague, especially for the time.  
R. J. 1 (Fife): probably Bergen.  
R. J. 2: Cadiz (EAJ3).  
Radio Bug (Leeds): would appear to be Aberdeen.  
F. Skeels: cannot trace item.  
Ashdown K.-H.G.: (20/1) Madrid (EAJ7), (24/1) Cadiz (EAJ3).  
Eric Charles: (1) Norddeich, every night, (2) Moscow (RDW), (3) Bergen, relaying Oslo, (4) apparently Helsingfors.  
G. L. C. (Sheffield): Newcastle-on-Tyne.  
Rustington: Madrid (EAJ7).  
Four-Valver (Basingstoke): (a) Hamburg, (b) Leipzig.  
Knob Twister: no French station on that W.L., was this not Moscow (RDW)?  
Erb: W.L. apparently wrong, might be WGY, Schenectady.  
Gecag: Feb. 6, apparently Oslo, but cannot trace Feb. 7.  
Johannes: Elberfeld relaying Muenster.  
Medico: (1) unless relayed by another station, it is most likely that Radio Toulouse was badly off its W.L., (2) no, when Hamburg relays from one of the sub-stations, it does so on its own W.L. The W.L. against the relay (e.g., Hanover, etc.) is only put there for the purposes of information.  
Brossley: presumably Oslo, but not advertised in programme.  
Family Four Bert: Cannot trace.  
Megohm (Tunbridge Wells), A. F. R., T. L. R. T., H. (Wallasey), Camhos (West Hartlepool), Trio: Please see paragraph entitled "Special German broadcast" on page 100 in last issue.  
Straight Four (Bromley), Copper Knob: Probably special transmission from Koenigswusterhausen but not in programme.  
Arc Lamp Martyr: (1) Munster relay of Elberfeld, (2) Bilbao (EAJ11).  
F. F.: No dream, but Berne on new W.L. 435 m.  
R. A. (Colchester): Presumably Ryvang but no detailed programme available.  
Dollar: Bilbao EAJ11; frequently changes its W.L.; now again on 415/418 m.  
Royal Fusilier: San Sebastian.  
Gin: Prague.  
Lactus: Madrid (EAJ6).  
Red Gauntlet (Reading): Would tally with Oslo.  
E. V. G. S.: Surely W.L. wrong or harmonic; talk tallies with Eiffel Tower.  
E. V. G. S. (Chung Services): Muenster relaying Elberfeld.  
E. V. G. S. (Church Service): Hilversum.  
Sand Grounder: Muenster relaying Elberfeld’s relay of foreign dance broadcast.  
Balgownie: San Sebastian.  
Radiotron (Eastbourne): Yes, probably Dundee.  
W. J. S.: 6NI, amateur (Bootle).  
Curious (Appleby): Radio-Toulouse.  
2 Valve: Oslo.  
Duoval: Madrid (EAJ6).  
Coilwinder (Derby): San Sebastian.  
Ras: Hamburg.  
Croxtonian (Southport): Toulouse testing on new W.L.  
3-Valver (X) (Hoddesdon): San Sebastian.  
Wave-Trap: Madrid.  
Barny: Brisbane, 4QG (385 m.), Sydney, 2FC (1100 m.), 2BL (353 m.) temporary.  
W. G. Gillatt: (1) Cannot trace 6AY, probably 6AI amateur (Swansea); (2) Cannot trace 5X2, but probably 5XU amateur (Dewsbury).  
Egap (Sherborne): Cannot trace - might be Warsaw.  
Fathead: FXN, British Amateur (Eltham) (Donian Gray), Hamburg.  
2v (Burnmouth): If 5NW British Amateur (Dundee).  
Wirlab (New Malden): New Rugby Station testing.  
A. L. M. (Dyserth): Pre-eminently KDKA base Pittsburgh.  
Wirexis (Portsmouth): Berne (then on 315 m.).  
G. B. Y.: Dortmund.  
Peto: Malmo (Call: Malmoens-Radio).  
B. T. Nameless (Harrow): If W.L. correct, Bilbao (EAJ9).  
Resistoflex: Buda-Pesth.  
Ex-R.C.O.S.: Madrid (EAJ7).  
Clem (Southampton): Koenigswusterhausen (English lesson).  
Luftforscher: W.L. very indefinite but do you mean Thursday 11th or Friday?  
Old Set (Pompey): Hamburg.  
One-Valver (Hastings): More likely Prague.  
Somerset (S.D.): Hilversum.  
Rams (Derby): Too vague but might be WGY (Schenectady).  
43 B. R. H., N8L: Prague.  
Target: Either Hamburg extended transmission or Madrid EAJ6.  
B.J. 7931: Radio Toulouse.  
Oscillating 'arry: W.L. wrong; cannot trace.  
Trapdyne: 6-Valver: Very scanty details; presumably Hamburg.  
De Bosco (Dorset): Cannot trace.  
Stunt Three (Sutherland): Graz.  
Wotwuzit (Cardiff): (a) Soro or Hjoerring; (b) Kiel (Morse, Ha).  
William (Swindon): Koenigswusterhausen (English lesson).  
No Name: (1250 m.) Relay of Copenhagen’s relay of Daventry. (5 February, 405 m.) details vague but presumably Muenster.