Hetty: Relay of Stockholm (Falun).

Somerset: (12.20) probably Milan, (12.45), Cadiz (EAJ3).

S.T. 100: Yes, Moscow.

Pakefield: probably Stuttgart. Imp (1) Berne, (2) Union Radio (Madrid).

DX Fisher (York): (a) Petit Parisien (Paris), (b) San Sebastian.

Ravelly: Relay of Stockholm (Karlsborg).

2LO: cannot trace on this W.L.

W.R.P. (Newport): Frankfort-on-Main.

John and Bull: cannot trace on this W.L.

Veloc: Radio Paris.

Erog: insufficient detail.

Colvister: Hanover (296 m.) Merry: probably Swedish relay, but cannot trace.

Stettin relaying Berlin.

Novice: Berne.

Nosey (W.W.3): insufficient detail.

Mat: Yes, Moscow Central.

Nob (Little Ilford): probably harmonic of Daventry relaying Princes Restaurant.

E.A.A. 1: Berne.

Upminster: (9.55) Frankfort-on-Main, (9.15) cannot trace.

Sunbeam (Chorley): Berne.

Dantesc (Leeds): Surely December 13, Hamburg. Please confirm again if heard on December 18, McMurtrie: cannot trace as no programmes available for devolution.

Amplidyn: estimated W.L. not given, presumably Moscow (Popoff).

Either Hogether (Pos): Koenigs wusterhausen (2,960 m.) News.

Alfredo: probably Norrkoeping relay of Stockholm.

Selim: Berlin.

EAA2: Cymbal.

Jam-Jar: Boms.

Taffy (Barmouth): Madrid (Union Radio).

Jason: Moscow Central.

Dewdrop: Milan (2MI).

F.T.: W.J.M. (Adelsthoe): Hamburg.

Doncaster: San Sebastian.

Electrode: probably Barcelona (EAJ1).

High-Power: Berne.

Whatnot: no date given.

JC Lozells: Job. V2 (Timperley): B.D.

Revo (Bradford): Philbob.

Jayeef: Sydn.

Isca: Mac.

Family Four: Shotley.

Earles Town: Megohm.

Sisce: Volupe Darwen.

Hot Dog: W.B. (Cheam): Iberica.

Vialato: Astwood (Worcester): Moscuito: Moscow Central.

Relay of Copenhagen.

XL: Both Moscow.

E.F.C. (Molesey): Berlin.

Eluff: Petit Parisien.

M.A.W.B.: probably Stuttgart, but not in programme.

Atahualpa (Liverpool): Atid: Berlin (1,300 m) relay of Copenhagen.

A.L.C.: Moscow.

Prestwich No. 1: Moscow.

B.A.W.: Madrid (EAJ4).

Zlat (Manchester): Berlin.

Wireless 4-Valver (Dover): Hamburg.

Raleigh: cannot trace, W.L. wrong.

Kit Cat: San Sebastian.

Robin S. (Lev): probably Malm√∂ relaying Oslo.

Mudrudy IV: too vague.

Combe: (1) KDR.

L: Leipzig.