Lanercost (Newcastle): (1) Langenberg (468.8 m.) relay of Carnival meeting at Düsseldorf; (2) Frankfort-on-Main (428 m.).  
Anglo-American Six (Southport): (1) The Elberfeld transmitter has been closed down; studio remains; (2) Langenberg, relay of Düsseldorf; (3) Langenberg; (4) Possibly Vienna; not in programmes.  
Enquirer (Harrogate): Either Frankfort-on-Main or Langenberg; both relayed Carnival meetings.  
Comox (Leigh-on-Sea): Rome, relayed from theatre.  
G. F. Hyde (Scarboro’): Leningrad.  
Mark Two (Chesterfield): (1) Leningrad; (2) Hilversum, relay of speech by the Mayor at Hertogenbosch.  
J. S. (Canterbury): Nuremberg; relaying Munich.  
Two Valver (Belfast): Brussels, relay of outside broadcast.  
4 D. B. (Harpenden): (1) Prague, relaying a symphony concert from public hall at Bratislava; (2) Possibly Frederikstad or Rjukan, relaying talk from Oslo.  
Phonetic (Darwen): Langenberg, relaying Carnival meeting from Düsseldorf.  
Noel (Barkhampton): Frankfort-on-Main (gramophone records).  
Parkin (Nottingham): No coupons sent.  
G. E. J. (Llanelly): Hamburg.  
Trilly (N.W. 8): Frankfort-on-Main (gramophone records).  
Walter (Newcastle-on-Tyne): Yes, it frequently links up with WGY and American stations in concerted WLS; given as 300-400 m.; this would include some fifty-five U.S.A. transmitters alone!  
Rumneyoh (Ireland): No WL. given, cannot trace from coils used.  
Mockeridge (Wembley): (1) No station advertised late transmission; cannot trace without estimated WL. (2) Koenigswusterhausen (Press); (3) Radio Paris; (4) Berlin (German National Anthem).  
S. T. 23 (Oldham): Yes, Langenberg frequently relays chimes from Cologne Cathedral.  
E. P. (Tiverton): Bergen (Evening Service from St. John’s Church).  
White (Frome): (1) Sorö, relaying foreign stations; (2) Leningrad; (3) Moscow, RDW (Opera “Faust”).  
Durley (Osterley): Porsgrund, relaying Oslo.  
W. W. (Devon): Karlsborg, relaying Stockholm.  
Neutrodyne (Dorking): (1) Leningrad; (2) More likely Warsaw (Radio Warszawa).  
Dunraven (Lasswade): (1) Madrid (EAJ7); (2) Possibly Bergen.  
O. V. 2 (Leicester): KDKA (East Pittsburgh).  
Hodson (Norwich): Prague.  
Exide (Tottenham): (1) Langenberg (gramophone records) (2) WL. wrong, cannot trace; (3) Vienna.  
Cymro-Celt (Bridgend): Daventry, relay of Albert Hall, Community Singing.  
Tretham (Mitcham): Barcelona (EAJ1).  
N. D. P. (Thorpe): No, Berlin (call was “Achtung”).  
Angell (Bristol): Coupon must be sent with.