```plaintext
Frederiksstad relaying Oslo.
Edwards (Finchley): Petit Parisien, Paris.
Hale and Hearty (Hull): A relay of the revue from Stockholm; WL. appears to be wrong.
Elliott (Darlington): WBZ (Springfield).
Balkwill (Torrington): Possibly KDKA direct, but Petit Parisien, Paris, on 340.9 m. relayed 2XAF, short wave transmitter of WGY (Schenectady) on the same night.
Joyce: WBZ (Springfield).
Carlow 213258: Karlsborg relaying a revue from Stockholm.
Petty (Bromley): You must estimate WL. in your queries; we cannot trace transmissions from dial readings.
Gordon (Mevagissey): Sorø relaying Copenhagen.
Driver (Skipton): Yes, WGY (Schenectady) also relayed to WBZ (Springfield).
Frinton: Believe Falun, unless new relay testing.
Puzzled (Normanton): Petit Parisien, Paris, relayed WGY, Schenectady.
In Love: (a) Oslo (Church service); (b) Prague.
2 Valve (Bredon): Madrid (EAJ7).
R.S.V.P. (Northampton): Berne.
Achtung (Didsbury): Karlsborg on 1,305 m.
Benjamin (Selly Park): Moscow (Central).
ZZZooOZZZ (Weston-super-Mare): Frankfort-on-Main, Cassel, Langenberg, Dortmund, Muenster, and Freiburg all took a concert from the Liederhalle, Stuttgart. Not a contralto, but Jan Kiepura, the Polish tenor.
3 Valves (Solihull): Lyons relaying PTT, Paris.
Woodward (Seven Kings): Sorø relaying Children’s Hour from Copenhagen.
Liam Senor Carlos (Jersey): Warsaw (“Radio Warsaw,”).
Walsh (Waterford): Karlsborg relaying a revue from Stockholm.
E. A. (Wells): (1) WL. wrong; Kovno; (2) Frederiksstad relaying Oslo.
Wabez (Hove): Rome gave a talk at 8.15 p.m. (Curious stories).
Mugpot (Garston): Rome on 452 m. (Madame Angot).
Dranoel (Bristol): Radio Toulouse (excerpts from Gounod’s Faust).
Wright (Spalding, Lincs.): (20) Radio Lyons; (21) YZ; Belfast; (22) Frankfort-on-Main; (23) Vienna (Rosenhuegel); (24) Barcelona (EAJ1); (25) Madrid (FAJ7).
Pearson (Mapperley): Radio-Iberica (Madrid).
```