Dickie: Berlin.
Terminal (Hampstead): presumably Cadiz (EAJ3) 360 m.
Can’t Believe It: W.L. too vague, but presumably U.S.A.
Ether (Northampton): (a) no coupon. (b) Paco (Cadiz, EAJ3). 
H.J.L.: no coupon.
Fawcett (Bishop Auckland): Madrid (EAJ7).
4 Valve (Ashford): Madrid (EAJ7).
A.E. (Highbury): W.L. too vague.
Iberica (Guildford): No French station on 1100 m.
European Experimenter: Bremen.
Coco Nib: No W.L. given.
No Answer: Hilversum.
Not Bad: Cannot confirm but believe Milan.
Triglow (Boscombe): Dundee.
P.P.G.3 (Slough): Madrid (EAJ7).
D.K.W. (Wednesbury): B.B.C. station.
Duke (Worksop): Hamburg.
B.A.L. (Addiscombe): Too vague.
Sorrento (Cobham): Prague.
N.S.R.L. (Seaton): Presumably Rome with altered programme.
Jonnie Ronnie (Redhill): (a) San Sebastian. (b) Cardiff. (c) Berne.
Pye (Northampton): Berlin testing.
Burn Valve (Soro, Denmark): 2,400 m.
Van Wart (Hall Green): Madrid (EAJ7).
A.J.G. (Leicester): Hamburg.
Fun (King’s Lynn): Barcelona (EAJ1).
X.L.: probably Hanover.
5LL: Bournemouth testing.
High Wavelength: Koenigs Wusterhausen testing.
Jarawoo (Manchester): More probably morse-sign.
MS: Muenster testing.
Winkle: Koenigs Wusterhausen (Press).
Curious (Dukinfield): presumably Prague.
Stockton: Radio Toulouse.
H.T.B. (Finchley): Zurich.
Ignorant (North Waltham): Very vague but probably Eiffel Tower (2,650 m.).
Chelsea Pensioner: Bournemouth testing.
Tommy Thumb (Leeds): Koenigs Wusterhausen relaying Berlin (Voxhaus).
Forest Hall: Aberdeen.
Fireside (East Ham): Milan.
R.F.R. (Brighton): San Sebastian.
Stancus (Bayswater): Rt. Hon. Winston Churchill’s Speech at Leeds.
Was this not Daventry?
Non-Osculator: J.28; 315-320 m.
Cannot trace; 355-360 m. probably Cadiz; January 27, Milan.
A.B.H. (S.E.8): B.B.C. station testing.
Auditus: Cannot trace this relay.
Lagos: Presumably WGY (Schenectady).
E.J.B. (W.I.): Cannot trace.
Keen Listener (Chronicle 2 Valve) (Warrington): Reinartz Three; Ashoff.
Cannot confirm, but believe WGY (Schenectady).