claritone (Worthing): Too vague etc. Chimes 5: Barcelona (EAJ13). (b) Madrid (EAJ7).
E.V.B.: Probably Berne and a B.B.C. station. Chritos Twin (Cardiff): Relay of PTT, Paris.
Advert (Canterbury): San Sebastian.
Daylight: (a), (b) (c) Too vague. Crosley: Rome. Ripple: Oslo.
O.E.A.: Prague. Keyston: Madrid (EAJ7).
Annibale (Swadlincote): Relay of PTT, Paris. Posavat (Laindon): Buda-Pesth.
Memo: Prague-Strasnice. L.42914: Hamburg. Coil Pusher: Moscow (RDW).
Neutrodyne V: 4 a.m. or p.m.? Strait Two: W.L. too vague to trace U.S.A. station.
Rover of the Ether (Hastings): If 5QM, yes.
Whizzie: Cannot trace, (1) ? Yes, Breslau; (2) Berne; (3) Breslau.
A.T.S. (Grimsby): Hamburg. C.M.W.J.H.S. (Leeds): Buda-Pesth.
The Society 3: Buda-Pesth. Midget One Valve: Amateur (Dundee).
Sunday Searcher: Presumably Moscow but programme not available.
Roxbor (St. Helens): PTT, Paris. P. & C. (Norwich): Frankfurt-on-Main.
Quixotic 6 HV: Probably KGO (Oakland).
D.X. (Northampton): Cannot trace on that W.L. Robbie, M.W.: (1) Yes, Breslau; (2) Berne; (3) Breslau.
Amateur (Lincoln): (8.45) San Sebastian; (8.20) Berne.
Derf: Both Rome. F.H. (Leicester): If EAJ6, cannot trace.
I.F.: Hamburg. Presumably relay of PTT, Paris.
Radio Robin (Morecambe): Cannot trace.
Night Oil (Brighton): W.L. wrong, probably Madrid (EAJ7).
Live Wire: Radio Toulouse (in dialect).
Edale: Cannot trace, W.L. wrong.
Psycho: San Sebastian.
K.J. Madge: Presumably Boden.
Duodyne (Macclesfield): (3.40) Do not understand query; (12.15) W.L. wrong ?
XGN (London): Amateur (London, W.2).
The Hut (Haughley): Koenigswusterhausen.
115 (Glasgow): (Midnight) Madrid (EAJ7) (11.50) relay of PTT, Paris; possibly Toulouse (280 m).
Pharmacist: Probably WJY (New York) but cannot confirm.
Haze (Press): Either Frankfurt-on-Main or Riga, but details of programmes not advertised.
Hove: Koenigswusterhausen. Elka: Cannot trace.
XYZ (Ashford): Relay of PTT, Paris (Toulouse).
Revophone: (24/1) Amateur (Tamworth) (26/1) Muenster.
4 V (Harrogate): (a) Relay of Stockholm (Boden) (b) presumably Madrid (EAJ6).
Parkway: Berlin. Bush (Barking): Madrid (EAJ6).
Straight Four (Erith): Berlin. Umidyne: Too vague.
Devon: Cannot trace, might be anybody.
Transformer: Koenigswusterhausen. Powerful Three: (a) San.